征永远 : 美国又一次把小伙伴耍了，日本人还没有回过神来！可恨，可笑，可悲，可怜！
与美相依amy : 很man
wangweigogo : 我只想到现实中前些日子广州地铁一个黑人狂扇一个中国男子时，竟无一个中国人站出来制止[挖鼻]
汪汪汪汪大 : 没完没了[眼泪][眼泪][眼泪] 精准(･ิϖ･ิ)っ
话废小能手 : 哦！我男神依旧那么帅！！！！
万人迷0220 : 确实帅！@良心犯
神魔井-四喜丸子 : 新晋全民男神
倪小Q : 回复@喜欢白色的明先生:哦！那就继续单纯声讨吧！
孙玮是谁 : 小龙人好样的！
白色衣服的姐姐 : 转发微博
張勁媌 : 男神你好帅
人生哲理大美女 : 轉發微博
小泽shinuki : 然而日本本地都没有新闻[挖鼻]日本群众都在吃瓜啥也不知道，也不知道日本政府想干啥
c加速跑 : 回复@爱折腾的贫下中农:那你还玩微博。看你头像有车吧
PreciousZoe : 日本不要得寸进尺，没完没了。[怒骂]
幸福和中 : @人民日报: 【人民微评：对话远胜对抗】选择对话而不是对抗，维护和平而不是制造分裂，中国东盟联合声明不提南海仲裁，传递出积极信号。那些选边站队的国家没有得逞，那些别有所图的国家该靠边站了。中国东盟本是命运共同体，即便有分歧，也完全可以通过谈判解决，将南海建设成为和平之海。
医生的小心脏 : 部长飚日语没有？
吼批王 : 回复@用户3i1cr3fklj:应该的
新闻_毒_毒_毒 : 王部长威武[赞]~~~对于此媒体个别编者同情违反规则被老虎伤害的游客问题，是否还有编者会同情违反规则和法律的无赖国家
大嘴世界男人 : 空话少说。多做实际行动。有意思吗？
学生刘洋 : 制造事端，惟恐天下不乱，转移目标，嫁借战场
拳击的艺术 : 那又如何，一些人傻钱多的汉奸，还不是回去他们的日本爹那旅游，送钱。
梦幻星座小马甲 : 你再这么帅下去，我会出柜的
星狼唯搏 : 已经一言不合了
Smile-China2012 : [赞][赞][赞]
劣1122 : 行不通就是干！！！
VionShop小铺 : 帅!
李小双baby : 看见男神好开心
qinqi_aini : 光说有用吗？一遍一遍有意思……？
痕之天使 : 好霸气
还有梦的男人 : 这个王毅也请了水军？还自封“男神”？
淡然4608 : 你们也不要一直就知道说，别没完没了，只说不做
萧天天天 : 放心了。[嘻嘻][嘻嘻]
老兵-893 : 王部长话应说再硬气点
云游诗人cmy : 看见祖国这么直白，我也就放心了。[doge]
何小徽呆呆 : 回复@亻可女肙:[哆啦A梦微笑][哈哈]$蓝海华腾 sz300484$  960#从此以后（电影《夏有乔木雅望天堂》主题曲）[音乐]##危城（电影《危城》同名主题曲）[音乐]#[嘻嘻][抓狂]  @妇产科医生王玉玲 [色]
天使孙悟空的金箍棒2008 : 直接开战
水皮吉他手 : 我是来数喷子的[doge]
夢想家殷先生 : 就是告诉日本鬼子“没你事你别bb 叽叽歪歪想挑事啊？”
今天很疯狂 : 好，这些硬气的话是英雄
拔屌相助 : 请来点实际行动，打嘴炮让小粉红高潮能玩多久，任何一方面都落后于人包括民众素质
-曾伟- : 回复@kiki-唐芳芳儿:他们不是喷子就是轮子
小糖米520 : 帅
猫小媛儿 : 不要敬酒不吃吃罚酒，不过话说日本人的民族性就是犯贱
MingElizabeth : 个性！
德斌红木家具 : 如果中国把日本干了，我会把我全部家当捐出去，虽然不多，，，
开心3824831014 : 敢说话的人！[花痴]
后天08256 : 回复@杨州李小丑:你胆子不少，脾气也不少，只是我想问一句，这时候发这样的火，合适吗？事有轻重缓急，别因一时之愤慨，忘了内外之别！！
飞向萝卜的床 : 南海是中国的
遗梦寻杏 : 嘴炮有嘛用？你倒是想个办法一了百了嘛
骑游中国 : 王毅好帅！
--小框 : 回复@青春短句:这是个借贷宝注册的骗子，不要信。
yokokosu : 回复@安之若素_1130:你呀 兔森破 桑塔斯 拿衣服
快乐同行310 : “没完没了”的口气太软了！
萋萋芳 : 这手势，瞅丫德行，边儿去，还没完了？你这个碧次！
以投 : 日本就是狗改不了吃屎。
天下雄鹰0001 : 如日方一意孤行，后果自负
H-Runj : 王毅外长确实干的漂亮，难怪外媒都评价有周公遗风。[爱你][爱你][爱你][爱你][爱你]
斌斌大鸭梨 : 其实还想加个凑不要脸，可惜不是外交词令
一生清福69 : 王毅中国铁骨脊梁
闫嘉允o3o : 日本自古咋都这么欠？这么多年过去了一点都不长进 爸爸都想收拾你了 个丢人货[弱]
中南资安院2013级本科支部 : 历史会告诉我们真相，中国已不是那个任人欺凌的弱国，豺狼来了有猎枪！！
时间海06 : 爱我中华
sweetie储储 : 王毅大大的外交能力实在太强，辛苦啦！任驻日大使的时候经常用一口流利的日语把日本记者吓地一愣一愣，这次会议让所有国家沉默，西方媒体都惊呆了。中国赢了！某些爱管闲事的国家可以闭嘴了，菲律宾花了那么多钱落得这副下场，好可怜啊[哈哈][哈哈][哈哈][哈哈]
睿理yyy : 男神
菁如阿 : 外长大人有您我们放心
菁如阿 : [强][强][强]感谢
娲朗 : 因为习总是鹰派，所以手下全部硬起来了，一句话中国不惹事也不怕事，更不怕战争！[哈哈][强壮]
和而不同不同 : [赞]
0_0kiki妞妞 : 已成我男神，收下膝盖。
我是洒脱的小强 : 没完没了，不要b脸，呸！！
相许lc : 回复@LJ-ZZOO:用心险恶
卖奶盖的小女孩 : 回复@嘎笨崔:我真是想笑～，我们现在讲的的是南海问题导致的中日两国关系恶化的问题，你给我扯到英国脱欧，我很想问问，你到底是怎么了解国家大事，和国际新闻的？你要是想向无知的人显示你多么懂些问题，我想你是找错人了。[挖鼻]
80后的千与千寻_53770 : [bm路过]@活在剧中的少女: 中国的外交部长就是帅！
江苏道法自然 : [赞]@法官爱民: 【人民微评：对话远胜对抗】选择对话而不是对抗，维护和平而不是制造分裂，中国东盟联合声明不提南海仲裁，传递出积极信号。那些选边站队的国家没有得逞，那些别有所图的国家该靠边站了。中国东盟本是命运共同体，即便有分歧，也完全可以通过谈判解决，将南海建设成为和平之海。
嘎笨崔 : 回复@卖奶盖的小女孩:哦！你注意没注意英国脱欧电台采访那些投支持票后悔了的都是什么人？妇女，妇女，还有一个因朋友投了反对票的19岁小伙儿。
词觃 : 牛逼！！
小u之恋 : 南海是我们的，虽也别想抢去，旱我国土
哆啦嗦啦嗦 : 对待日本态度强硬，它才意识到中国也不是好惹的，人不犯我我不犯人，人若犯我我必犯人！！！支持王毅部长，中国能有这样的外交部长真叫人放心！做得真好！！！[爱你]
微山湖边旱鸭子 : 没完没了，爸爸已经不想和你们玩外交辞令了。
一只臭袜子5 : 没完没了！霸！气！
好姑凉lyn : 男神！[爱你]
荣子-小幺 : 没完没了
卖奶盖的小女孩 : 回复@嘎笨崔:我不是学政治的，更不是外交官，但我只知道作为一个中国人不站在天天设身处地为国家，百姓着想的领导人这边，而是在那乱喷，这种人自己该反思
wiwi爱 : 日本总是要蹭着中国刷存在感，关他什么事了，无聊、无耻！
peaceminusonexs : 我家idol发话了，好帅啊[好爱哦][好爱哦][好爱哦][好爱哦][好爱哦][好爱哦][好爱哦][好爱哦][好爱哦][好爱哦][好爱哦][好爱哦][好爱哦][好爱哦][好爱哦][好爱哦][好爱哦]
老实憨厚的秃林 : 王叔真帅气，有当初恩来总理谦虚儒雅的外交风范，当然领土问题上是绝不退让的。
群微米 : 再加一句，臭不要脸
恋忆雨 : 大爱王毅[good]
Brave-希希 : 坚决拥护党中央就南海问题的各项决策。[good]
嘎笨崔 : 回复@卖奶盖的小女孩:额，你懂外交？你懂政治？他能有薄帅？噗~~
在尼身边 : [兔子]王毅叔叔太帅了
阿阿孙 : 回复@手机用户0000725:怎么
Rapuuunzel_ : 回复@花椒大料与八角:啊 这气势 吓死你
爱折腾的贫下中农 : 打吧  打 吧   我们连房子都住不起的人 还怕经济在倒退吗？还怕换党换政府吗
NEW-FARMER-XU : 日本鬼子太坏了，从头坏到脚！以后一定要报复这群畜牲，以牙还牙！
咋个取名字你不知道是我 : 是的是的，男神简直棒棒哒
小资情调zh : 帅[威武][威武][威武]
卖奶盖的小女孩 : 回复@旷野的呼喊:叫你家居委会大妈，骂个看看 [生气]，搞得像你多懂外交似得，不懂别
丽茹猴猴过 : 我想看视频
就想发个说说 : 呵呵，继续捧，我就想说当初某人刚上去也是捧得很厉害，不排除水军，现在呢，呵呵
苏州会粹 : 中国人粗制滥造？中国有精美到您想都不敢想的艺术品服装；中国有漂亮得您见都没见过的艺术品服饰!那就是世界上独一无二的：会粹专利双面苏绣系列产品!看看吧，以针作画，巧夺天工
memory-Zrl : [赞]
以缺德服人 : 话在理，关键是人家听不听，帝国主义都觉得自己很吊，而且不听劝。
狂嗨青春 : 必须霸气
传媒聚焦V : 貌似很牛叉的样子！[哈哈][哈哈][哈哈][哈哈]
猪仔仔的小窝 : 就是这么硬气！
晏三丰富 : 日本就是驴叫不改！驴脸皮厚[哈哈][哈哈][哈哈]
我滴愿望西世界和平 : 王毅爸爸，你太帅了[羞嗒嗒]
_FFFFFFY : 批话多，闭嘴[微笑]
水晶便便爱吐槽 : 不要一错再错，没完没了，否则，咱们不见不散
瑞歐56070 : 帅我一脸血，好吗
unique饭饭 : 终于知道为什么是男神了
Miracle小五 : 实在是霸气[good]
股市路明泽 : 日本人是在刷存在感？你们日本的特产已经很有存在感了好不，想到日本我就满脑子的马赛克
赤道仙人球 : 酷
南宫捅刀姬 : 翻译“小样儿，没完了你还”@刀无极家的小锦鲤: 哈哈哈哈哈哈哈
分享观赏 : 日本真烦人，时不时搞一小动作。
沈林滨 : 看到中国王老干部那么拽  把手机关了  我也就放心了[doge][doge]
北辰旧账 : 回复@长脖子鹿尤lady:知道腊肉杀多少人吗？
觉梦遥i : 毅叔[强壮]
张永琪 : 小日本  别BB  有本事开战
童话式Di结局 : 老王不耐烦了[嘻嘻]
兔临天下 : 没完没了，真想一脚踢你出地球，国格如此下贱！在你隔壁都嫌脏！狗日！
暮雨春芽 : 我是来看欧巴的[色][色][色]
火柴点地雷 : 再叼，封杀东京热[doge][doge][doge]
为师不想说 : 配图是说： 演AV的后门直走
adminXZZ : 好帅，有颜值
饼王1968 : [给力][威武][赞]
深圳市福鑫代理记账有限公司 : 没完没了是什么个意思懂么！就是不要再来烦我了！我没有耐心了[哈哈][哈哈]
fh718903505 : 中国最强硬外交官[鲜花][鲜花][鲜花]
到底怎么才能取个用户名 : 说的好
橘子它打我 : 最帅[哆啦A梦微笑]
Missbalaba : 日方！甭逼逼！
就叫我大神吧_ : 王毅：日方，我劝你不要太叼[doge]
京孚光电 : 点赞
神奇局长 : 其实，菲律宾仲裁，只是提前走了先手，先找法理根据。一旦天朝有变，无暇顾及，菲佣（东南亚国家）势必抢夺南海。#南海仲裁案# 
Vinnolo : 不要一错再错，没完没了[怒骂][怒骂]
鹿晗派 : 爱奇艺会员8元1月   55元1年     不是共享账号，是属于你自己的，一人一个 要的私信我
省冠阿文 : 这老头真帅
M谭点点M : 回复@陌洛落wy:看来是老乡见老乡了[微笑]
我还是叫于小宝吧 : 没完没了，烦不烦
危笑的国王 : 日本政府该换人了，中国是文明有素质的国家，也是希望和平的国家，我知道日本有大部分的人承认了日本侵略中国和其他国家的事实也真心的认错了，但是在日本还有少部分人和政客恬不知耻的教唆诋毁污蔑中国和中国主权的问题，日本一定要消灭这一部分害虫。维持两国的和平。
长脖子鹿尤lady : 我就不明白那些天天鼓吹日本友好的国家，你们真的瞎吗？日本是个侵略者，杀害了几十万中华同胞，现在又到处挑唆，企图和美国一起围堵中国发展。这是一个友好的国家吗？你们是真瞎还是装瞎，我不是小心眼，我觉得日本的所作所为不值得原谅
尘埃落定198611 : 要么武力解决，要么经济制裁
鱼粥湖 : 小日本鬼子真妈的不要脸，钓鱼岛事还没完，又来南海闹
用户5771235902 : 回复@众里寻茜千百度:这个你说得对，大家都叫他老公那他老婆岂不是……
用户5771235902 : 这是警告   中国：小日本你们在bb就不要怪我不客气了
牛肉饼大魔王本尊 : 回复@365全死角女神经:舔王毅的蠢猪们，你们咋不舔洪磊？他的颜艺和姿势更夸张
冰糖丫丫zt : 王毅已经结婚了，这个不能喊老公
用户5549755322 : 中国人民热爱和平，但也不畏惧战争。原来只是忍，谦让，现在反击了，还是挣了，以后有可能会主动打击任何一个国家，那都是被逼的。
刘茜茜眼神不好得长心 : 没完没了这个词用得不错[doge]
一生换须臾 : 通俗点讲就是别给脸不要脸。
BiBi_Monsters : 部长说什么都对[微笑]
冰糖丫丫zt : 王毅已经结婚了，这个不能喊老公
陌洛落wy : 回复@M谭点点M:热门评论里看见大同，我激动了一下
紫凝汐--L : 部长威武
一有妹子就性冷淡_Sun : 男神帅气[爱你][心]
明明就07542 : 外长手势意思是，日本人你给我有多远滚多远。[微笑]
下山老虎打 : 就是就是，能不能让我们部长省点心！
笨铎的比宝 : @笨宝的笨铎 在新闻里说某些外域势力异常兴奋[笑cry]
Camille_糸甘上知 : 日本真鸡婆
随它吧26 : 怎么那么帅呢  痴汉脸 真心给为了中国和平发展不停歇一直努力着的每一位 说一声 辛苦了   渺小的我们能做的就是做好自己 不给国家添乱
l莹zi : [good][good][good]帅
大雨麻麻Rain起来 : 手势：卖AV的出去[微笑]
我是一个默默无闻 : 自己不强大就只能被欺负，今天我们站在这里强调尊严和正义，讲究骨气和脸面，可是别人根本就没有把这种表面的花哨当回事。有时候嘴上得势并不意味着理在你那，真正能改变这个理字的是综合国力和世界的影响力。美国重返亚太就是要表明自己的军事主导地位，我们在这里谴责别人一样会实施，关键还是要有钱
特别胸特别爱 : 最讨厌卖光碟的，卖香蕉的[狗][狗]
Somany碧 : 小龙人[哈哈]
乂小小晓晓 : 鼓掌[鼓掌][鼓掌][鼓掌][鼓掌][鼓掌][鼓掌]
喜欢凑热闹的围观群众 : 不要脸的日本啊，没完没了的纠缠，他妈的不给它一颗原子弹它是不会消停了
我永远是你最酷的爸爸 : 你中国爸爸不是吃素的[可爱]
周梦琳199809 : 部长好帅！！！
天持衡 : 日本说啥了？而且外交官训别国很那啥。
爱小兮 : 男神不用说话光眼神就能沉了日本岛[偷乐]
北巷孤人0 : 威武。威武。威武
米汁萝卜 : 就是这样，帅！
即使一秒钟也难承受 : 男神！
wow_Im_Joyce : 帅气
花椒大料与八角 : 哈哈哈美男子@Rapuuunzel_ 即使老了我也喜欢
__旧城故人y : 男神！
Fyh付雨涵 : [good][good][good][good][good][good][太開心]
我的心只悲伤seven次 : 王毅部长，新晋男生[鲜花]
萌妹子妈咪_唯爱 : 新晋全民男神，男神哟[good][good][good][good]
酷校职业教育 : 帅！！
钟_小_雯 : 奉劝一词是客气的 小日本
路边的小草你别踩 : 如果西方国家是一群狼，那么日本就是一条狗！。对于狗是无需讲道理只能用打狗棍了！
卡娃依欧 : 我郑重宣布：王外長真像我外婆。反复讲，讲反复。@捉鸡逗逼:我单方面宣布王外长是我干爹[doge]
马里奥的xiao99 : 王毅大帅锅  赞  日本狗永远的完蛋！
福娃摩斯 : [爱你]王毅[心][心][心][心][心][心][心][心][心][心][心]
不修边幅的女魔头 : 帅气
论语--为政 : 日本政府最大的特点，从不说实话，从来都是喜欢偷偷摸摸的做一些见不得光的事！
NJ_LIX_ : 一看就知道不是伪娘就是gay
用户5975758343 : 王外长，保重，
用户5534302144 : 日本右翼政府班子延续军国主义政策，指望它们对中国友好是不可能的。支持王毅外长。
HsLyl1120 : 回复@Win厸_:[脸红]
土土兔子大金牛 : 回复@LJ-ZZOO:你美爹今晚发你100块，继续好好干给你在底斯律一套房
FasJyou : 男神说话真帅[doge]不要给我没完没了
KING_nosmo : 看见大家用嘴打仗我也就放心了
姚笑蕾 : 吊吊吊
天蓝风清月明 : 男神[心][心][心]
小太阳爱看微博 : 威武
清风弹珠 : 对牛弹琴有用吗？必要时还是给一顿皮鞭就老实了。
战空城 : [炸鸡和啤酒][炸鸡和啤酒][炸鸡和啤酒]
库里日天 : 国家兴亡，匹夫有责。大敌当前，戮力同心，捍卫主权。
闲来无事真烦恼 : 男神
小屁孩的养乐多 : 为什么有的不能评论？
这个手刹不太灵呀 : 王部长的意思是：你爸爸都没话说了，你一条狗在这里乱吠个什么劲
藰3226740212 : 小日本都他妈的去死吧！中国永远必胜！
80後宅男81406 : 主人都说别叫唤了，[狗]还得吼几声。
real__hl : 部长如此帅，干得漂亮
佳妮精工织补坊 : 回复@不会飞的天使爱发呆006 的赞:国人要有骨气，打扙帮不上忙。有钱了，能否少去或不去：日本、韩国、美国、澳洲！提振他国经济，是间接帮他们造军舰，导弹，飞机，国人要醒醒！为什么外国人，不尊重中国？因为相当一部分有钱国人，太贱！！！网友认可，帮转发。
冯某某__ : 王部长威武！！！
偷生远方里l : 说让公布资产内个你好像智障 没错 就是你[怒]
顾城之南 : 王外长粉丝团的微博 怎么没有了？谁能解释下嘛？
抠脚女汉纸淘宝旗舰店 : 在墨迹连日本一起收复然后天海祐希就是我们的了
江辰同学 : 日本真的是为达目的不择手段，必须要强力反击！连美国主子都妥协了，他还在没完没了的蹦跶。
我又不是李大仁 : 小日本，不要没完没了了啊
微風往事1983 : 说的不做，做的不说
来包二重积分 : 气质的迷人挡也挡不住啊
烈如歌521 : 最帅的手势[good]
煤气宝宝呦呦呦 : 转发微博
光蓮弍姐_ : 日本真是个不识好歹的东西
超级兔子234 : 哦
花开莫离琪 : 王毅好帅[good]
M哇M : 男神好霸气[强壮]
叮咚20160202 : 日本人不要忘记谁把你们从石器时代拽到了铁器时代，是我们中国。
泥鳅面相 : 还真是没完没了了
Victoria_是小盆友呀 : 帅帅帅
123456-柒 : 这手势的意思是：门在那边，卖AV的请出去。[doge]
----Evie----- : 哈哈哈没完没了
Mr_萧泽文 : 再BB以后不许你们国家的AV进大中国了
将琴代语兮聊写衷肠 : 老公
l不安分的心v : 王外长是最有魄力的，打倒小日本
MENG梦瑶瑶瑶瑶 : 小日本 别敬屎不吃吃罚屎
一片安眠药plus : 回复@钢铁灬加鲁鲁:可以反政党，但是殖民地是什么鬼？维护祖国领土主权不容侵犯ok？
手机用户5093412283 : 又是在耍耍嘴皮子，吓唬谁？
谁动了我的情弦- : 说出了中国人的骨气，大写的帅，小日本再逼逼就是找削[哼]
小萌瓜爱吃糖 : 男神 霸气[爱你][爱你][爱你]
一杯清茶94787 : 美国和日本一样不讲信用，说一套做一套。
我起那么长 : 说得好！部长真帅
用户3784000502 : 说的太好了。
慢慢很慢 : 我来给大家翻译一下——“小日本，别给脸不要脸昂！”
悠悠部落 : 日本就是欠揍
当我不再注视你 : 太帅了！简直！
芬妮在河北 : 王毅说的好[赞啊]日本狗不打不行！
尒朩耦YCS : 天天全是官话，没一点实际行动
戴维是只小土狗 : 不要一错再错听见没[嘻嘻]
小猪买幸福 : 霸气
Garryti-C-He : 中国是有自己的话语权的，这是我们作为当事国的权利，你一个小小的日本，一而再再而三地来干涉。信不信每年不出口树木给你巩固国土，要不了几年，我们见证你自己沉没！
小义程 : 王之藐视
Alu20131415 : 老是说这些不疼不痒的话总是吓不住人
未闻花落知多少 : 可以，这很强势！
你再不是我的顶礼膜拜 : 男神，帅呆了
肖梁建 : @子夜打晃晃 [奥特曼]
CJ爱阿卒 : 帅
第9小时-三众模型 : 支持
嘿2013 : 大爱王毅[心]
刘聪同學 : 不要没完没了[威武]
反TFBOY掏粪联盟 : 中国人民全力支持恐怖主义[good][good]！搞乱日本社会秩序！我们中国就能强大了[哈哈][哈哈][耶][耶]
莫辰同學 : 王大哥就是帅！
张建文poss- : 帅
涩色柠檬 : 奉劝日方不要一错再错，没完没了
就酱饭团儿 : 中国又出了一位强势的外交家，点赞
娃娃家专属 : 帅
跑腿儿小编 : 说得好！！！
西红柿炒蛋盖饭 : 中国外交部长，真是帅帅达，
丶晓楽子 : 回复@青春短句:。。。。
北京一元 : 转发。
饿货美食家 : 给毅老大惹毛了有你们小日本儿龟儿子好受的
靎Linda : 我政界男神[给力]
tracy_1107 : 哈哈哈，小日本别没完没了，唧唧歪歪
薄荷200305 : 男神最帅[花痴] [花痴] [花痴]
静静看就好 : 王蜀黍就是这么帅[鲜花][鲜花]
禅雨茶香 : 意思就是我忍你很久了  你不要再骚扰我了
Yolanda_Zjie : 这绝对是我第一男神
赵了个皮 : 帅
忠厚老实极了 : 回复@璀璨下的霓裳:难道你连屁都不懂？
法藏大师 : 警告到一定程度就不客气了
璀璨下的霓裳 : 回复@忠厚老实极了:你懂个屁
拉丝不带纸 : 就要这么霸气
夏日微凉020 : 真是没完没了了，都说不要死缠着不放，和你没关系，真是听不懂还是没翻译→_→
新兵931931 : 回复@涵曦LATOJA苗儿:你有脑子，但很残疾
阿毛方方 : 别特么没完没了！
涵曦LATOJA苗儿 : 都说吃水不忘挖井人，知恩图报，日本这个不知道感恩的国家，也不想想是谁给了他文化，没有中国古人的帮助，能有他吗，再没完没了，他老子就要揍他了
用户8z6xqull5p : 看王毅突然想起敬爱的周总理！
忠厚老实极了 : 奉劝中国外长：拿人家没办法就好好谈呗，别没完没了地奉劝了，成不？
义乌市米丁电子商务商行 : 牛
之昂张痴恩晨 : 回复@NO蒜:搞个人崇拜最有一套了！封建社会都没有当今厉害
涵曦LATOJA苗儿 : 回复@新兵931931:有没有脑子啊你，知道战争的后果吗……
一只财产保险的小白 : 中国是克制太久了，一句别没完没了了就让我热血沸腾了[哼]
chris-vivian : 图解：出去！
小潘爱搭配1299996 : 什么都有小日本的臭脚
北风其凉i : 太帅了
无情小姐姐jpg : 回复@_刘小影:[心][心]
补溢心肾之气忘 : 被迷住了
转眼一瞬间0808 : 真帅
微wbbdyy : 有底气才有脾气，国家如是，男人也如是！[拳头]
新兵931931 : 我们期待的是一场卫国战，不是一场唇枪舌战
沫宸妈 : 霸气
李艺yibaibai : 中国的男神[哆啦A梦花心]
奥利奥的香香 : 帅炸
Tst活酵母小黄 : 中国加油
蔚蓝藤蔓 : 就是 不要没完没了[威武]
河马的企鹅的小龙_WJ : 别人的男神是明星 我心中的男神是他！绝对～
我是祖国的狗腿子 : 666666
沁亦小杏 : 毅大大，帅！霸气
阿三的诗 : 霸气[心]
M_xuelian : 霸气，男神
她腐朽年华万 : 帅，日本人太贱
还不是要微笑面对生活 : 帅
1989年版马天佑 : 我觉得说别给脸不要脸，好点
onepiece地雷 : 太帅了！！！！
大豆包YY : 应该换成不要没事找事
安道休 : 王部长么么哒[飞吻][飞吻]
金信润天武汉分公司 : @田-爷爷
靠谱的穷人365 : 人日，你美爹撤退了。[笑cry][哈哈]
佑龙弘德 : 外交部长应该是一个少说话的人，而不是一个会说话的人！
杨州李小丑 : 王毅你他妈知道中国人有没有人权啊，你这狗
重庆瑞思学科英语 : 我们玩得那么欢脱，日本当然想跟我们一起玩咯。。。。
是我想不到好名字 : 在逼我我就抗议啦
英国jeremy : 一错再错...呵呵..
祈章_ : 没完没了[笑cry]
LaDy_娜娜 : 我们天团说了不要没完没了听到没有[怒骂][怒骂][怒骂]
仰望星空_仰望你 : 我国主权不容侵犯，日本蓄意滋事世人谴责。
Leslie我好挂住你 : 没完没了
心浪里戈浪 : 威武霸气，魅力爆表的中国外长，戳折手指也要点赞[good][good][good]
谢谢侬xiaxianong : 让我想到了高中很有气质的一位英语老师，那时候我们班女生也是老师的迷妹呀[爱你]
用户m18s7k7aa0 : 支持外交部长给小日本的警告。
清冷晨霜攀黛瓦 : 没完没了让你吃不了兜着走
天下古大龙 : 关于南海：开放其中一个或多个岛建成海上综合补给基地，并对外宣传欢迎各国商船前来补给，则西媒所诬的中方影响航行自由不攻自破。
0_Noway : 别叨叨了，南海那么多岛，你先占全了再说，有什么用
刘德华的粉丝99 : 油炸日本鬼子
栀墨的微博 : 奉劝日本，好好说话！
Lwy远隔如斯 : 为啥没有评论转发
临沂临港环境 : 【王毅：奉劝日方不要一错再错，没完没了】
ZHA0FANTING : 霸气
人生哲理大美女 : 轉發微博
冲圈先生hhh : 赞赞赞
何时清风 : 帅！
大脸家的喵女 : 就要这么简单之霸气
孟婆没有汤能咋滴 : 棍棒底下出孝子 在这里可以很好的运用
Silence我怀念的 : 奉劝一句，中方不要再一味谴责了！要换换口味了！抗议抗议！
艾文兒- : 没完没了[good]
反TFBOY掏粪联盟 : 全中国人民支持恐怖主义[good][good]！ 搞乱日本社会秩序，我们中国就能强大了[哈哈][哈哈][耶][耶]
以琳yesuaini : 帅气
D---Moira : #王毅外长##给王毅外长点赞#果然是我王大大，点赞[赞][赞][赞]
吴肉肉他妈 : 强行出场，强行碰瓷
梅梅梅竹 : 我王部长就这么帅
瓦干 : 顶
ZeroWu- : 小日本没完没了~
奔跑的炒馒头 : 没完没了。就打他个操滴
饱肚阿 : 拍AV的先出去
媛媛姑娘626 : 日本人狗腿嘴脸暴露无遗！替美国人当前锋，搞乱亚洲，想重新侵略亚洲咋地？伊拉克，利比亚，叙利亚就是前车之鉴，中国绝不会坐视美日狼子野心。
木木木木木匠 : 部长好帅[色]
乱乱G意 : 解释一下：日本，该你jm事，滚犊子，败磨磨唧唧，个biang彪
丘小花_ : 我这辈子最爱周杰伦， 但是周杰伦出现我不一定会喊我爱你， 但是看到王毅跟局座 ……… 啊啊啊啊啊啊啊 我爱你！！！！！[心]
郸城鲁方 : 回复@_刘小影:没看出来他分析出什么了，只感觉到扯淡。比方说：如果有个人跑到你家门口说：你家的另外一套房子是我的，因为我租过那房子。你会给他一耳光还是忍气吞声？南海问题和钓鱼岛问题就如同上面例子中的房子。如果你选择忍气吞声，那么我想问，你家房子还租吗？
喜欢哈密瓜的味道 : 求求相关人员救救我弟弟吧，醉酒误入他人住宅，半年后竟然被起诉，我弟弟要被判刑十二年，冤无处申…！ 麻烦网友们把我顶上去吧，深深感谢你们
中捷无忧生活 : 好霸气！！！
鱼冻_51935 : 中国说话越来越硬气，是因为中国的综合国力越来越强大。
宝and江-718 : 去死吧，日本人
时间吞噬思念 : 给你点脸了？别没完没了小心爸爸打你
orange蓝夏 : [good][good]主权问题，必须强硬[强]
罗祥2020 : 不服就赏他两枚核弹
深圳益尚导医妹子 : 不惹事 不怕事
听见冬天的离开5 : 赞！！
joker丶希斯 : 回复@LJ-ZZOO:你这种人就是闲的唱反调
我代表也搞不懂而不 : 小日本子~！！！！！！！！！！
聚焦亚太 : 【日本肯定别有试图！】如果仅把日本看作是美国打手有可能错了，因为日本一直有侵略梦！日本与美国不同，美国是举着“伸张正义，世界警察”的旗号，用霸权思维强行介入南海争端，目的是维护霸权地位；而日本，是彻头彻尾想通过武力搅局南海，拉美国下水，牵制中国，图谋钓鱼岛及更多领土！警钟长鸣！
汽车保险全省最低价 : [微笑]@小飞侠tbG: 上战场吧。真刀真枪的干。
我就like紫色 : 王毅~
李义Jack : 中华雄起
永远合作环保种养满商品交易平台 : 真有这事，有必要？怎么还没打？这是一场生化战争，经济战争，反正不好的人，八年够你死啦，死不了都成负债货。
哆啦c梦微想 : [哼]
qiebaobo : 真是没完没了了
疯子王的王 : 王部长新晋网红[心]
卖卫生巾的女孩儿 : 就是这么霸气！！！！！！我的徽号15964784687欢迎骚扰
_刘小影 : 回复@无情小姐姐jpg:终于看到一个会分析的人了
薄荷叶配荷包蛋呀 : 王外长说，日本佬你莫给老子多管闲事， [愤怒]在bb就要挨打了
此琰非彼琰 : 他是我最欣赏的中国人。
致少我记忆里有你的微笑 : 回复@LJ-ZZOO:什么垃圾东西都有
Aairrrr : 回复@LJ-ZZOO:你脑子有病
小飞侠tbG : 上战场吧。真刀真枪的干。
黑里俏俏俏 : 自从南海事件后，看到一些导游发票圈，还频繁带团去日本，讲真[doge][doge]就不能换个国家 就不能嘛
薇薇的小小世界 : 翻译：管你jb屌事，再bb老子抽你！[doge][doge]
光纤入户 : 王毅的话翻译一下就是别给脸不要脸@日经中文网
Ray字辈的出列 : 头一回电视上见到他      吓了一跳       特别像年画上的门神        他是我国们国家的门神呀
桂人堂健康如金 : #转发抽奖# [嘻嘻]
无情小姐姐jpg : 什么叫只会打嘴仗，让别国挑一下就起火就要开战的，那是对民众负责的领导人吗。
BlueberryJ : 祖国的态度越来越强硬了[强]
卤蛋咚 : 王男神说…爸爸马上要打人了
kkkkkktt : [奥特曼][威武][给力][给力][赞啊][赞啊][推荐][推荐][推荐]
大麦舂子 : 有局座和大王，量他们也不敢造次
大琪仔77 : 揍他呗？我准备好了
小屁孩红星闪闪 : 欣赏王毅作风。。
盘龙城公民 : 你们知道姨妈巾为什么不用红墨水嘛？   知道的别赞。不想火[哼]
囍媛000 : 这些憨[狗]JB日的日本领导者！
BaoQiua : 大王神了。
月明湿素霰 : 王外长帅裂天际[害羞][害羞][害羞]
伊伊mico : 好帅！
六快拨 : 咋那么恨小日本儿呢   不消停、、、
kevin-pmj : 回复@策白马啸西风fyl:你說的太適合你了，只要把主語換一下，井底瞎蛙
一定不吃糖 : 我男神就是帅，霸气！
冷昊BOY : 干死小日本[拳头]
钢铁灬加鲁鲁 : 入党积极分子真多啊！
NO蒜 : 回复@之昂张痴恩晨:共产主义国家的特色
罡毅2016 : 日本想见你们就见，人家却一点也不给脸。说那么多不如像日本做点什么！
老秃子 : 别她妈给脸不要脸，老子发火起来，怕你招架不住
铭刀011 : 现在我终于发现最不要脸的就是小日本
钢铁灬加鲁鲁 : 回复@取个撒子名字给兰明星:不滚
钢铁灬加鲁鲁 : 回复@打鼠喵喵侠owo:我脖子顶上没东西啊？你是共产党员吗？
meinv晶晶 : 中国最帅的男人
宝妍Ti-Amo : 大爱王毅，像样儿
唐xxBoy : 相信国家的各种战略，中国会越来越好[心][心][心]
钢铁灬加鲁鲁 : 回复@一片安眠药plus:不是刷存在感啊，上海人就不能反共了？
梦想花园_RONG : 日本不要一错再错[怒]
烟尖儿丶 : 霸气
vina姐姐多笑笑 : 手势的含义：给我滚粗去！有多远滚多远
钢铁灬加鲁鲁 : 回复@糖糖糖糖糖小-雨:我没有劝谁动武啊，为什么要学国际法啊？
_风中凌乱的女纸 : 中国爸爸！棒！
哩啦弄哩啦哩啦哩啦弄 : 合照的时候，那手势很帅！
岂非皇 : [doge]我看成了【希望日本不要再错，作业没完没了】
fackyoushit : [爱你][爱你][爱你][爱你][爱你][爱你][爱你][爱你][爱你][爱你]
钢铁灬加鲁鲁 : 回复@慕北Grace:噢
钢铁灬加鲁鲁 : 回复@Okaykaka:我工资是德国人给我发的。我也不是汉族人。
子虚乌有的铭 : 回复@sirsnow:呵呵
爱吃鱼的眼睛兔 : 美国说南海诸岛离菲律宾更近，应该归菲律宾！其实菲律宾和日本离中国更近！！！！
鎏金瓦卡亚酷咧 : 望你谨言慎行[微笑]
dragon9880818 : 王大大是真的帅[哆啦A梦汗][哆啦A梦汗][哆啦A梦汗]
惜花阁-猥大仙-慕hang : 简单的说，就是：日本你别在这巴拉巴拉，死开！
Mr-Cheshire-cat : 王毅大大其实想说:“你个倭寇别给脸不要脸[挖鼻]”
鸿凯电商的微笑 : 王大舅[赞]
Sybil回到原点 : 大王
EVAXSS : 粉丝政治
东山朝霞 : 曰本是个野心家，与他讲道理没用，最好的办法是让他服软，把他打扒下。
Jo克叔叔 : 外交部长也是实力圈粉。
果果昊_6872 : 南海仲裁后放一边不管它。也不急着与菲律宾对话谈判。加快建设黄岩岛。这是我的想法，或许管用。[哈哈][哈哈][哈哈]王外长费劲人吃亏戏也不好看！[哈哈][哈哈][哈哈]
飞不上蓝天的乌克兰小乳猪 : TO日本：请不要一错再错，没完没了！
扫荡 : 回复@LJ-ZZOO:就你这种弱智最烦
神盾局盾长 : 博主么么哒～真爱粉又来互动啦    此消息由战鬼微博秘书发送
之昂张痴恩晨 : 从没见过哪个国家的人如此脑残的热爱一名政客
TZcatherine : 太帅了，霸气[爱你][爱你]
王小羋nic : 日本外相长的有点猥琐呢，哈哈[开心] 
四叶草_68048 : 同意
罗那尔朵是我619 : 有的人骂汉武帝，发动战阵民不聊生。试问有钱有武器，我们何必再受气，肌肉发达就是吓吓人吗？让他得瑟，迟早收了他。更何况他曾经欺负过我们，侮辱过我们的民族。
Me薇女郎 : 不要一错再错 没完没了 多么霸气的一句话 尤其是后一句 咱们国家需要这样的领导人物  大赞[强]
Carling3 : 我的男神就是又帅又酷的外长，我已成为脑残粉。[笑cry][笑cry]
四爷伤不起 : 卡布达劝你最好谨言慎行
梦见你的梦里梦见 : 王外交一直都这么霸气，帅呆了，哈哈！藐视小日本的眼神，好像在说：智障，别说话
茕兔不是穷兔 : [微笑]美国爸爸都不BB了日本是怕自己的钱白花吗
straytttt : 潜台词     哥屋恩#中国一点都不能少#
舔舔小蛤蟆 : 看到评论才发现出门和上网不带脑子的可怕。评论里有一部分没带脑子。
可爱的洪水猛兽啊 : 迷妹在这里
晚上好夏天小姐 : 帅呆了
手机用户2874698793 : 王部长威武，大爱！我们中国领导人的骄傲，全国人民都爱您，霸气，帅气！
君子撄宁 : 抵制日货，让他们还没完没了？！！
长乐圩民 : 回复@快要被你蠢哭了:又是个不讲道理或不会讲道理的。
SS______SS : 男神
快要被你蠢哭了 : 回复@长乐圩民:我们自己家的事情，关日本什么事情？狼子野心你不懂吗
冯啊雪R : 霸气[心][心]
雁雁羽飞 : 以前我的男神是陈道明，现在又多了王毅。
普通变态 : 你中国爸爸不耐烦了
长乐圩民 : 为什么要动员那么多非当事国表态？谈，就要讲点道理。别老拿不是当事国当说法。道理，很多与是不是当事国关系真的不大。如果不是当事国都不能说话，那这个世界岂不真成了弱肉强食了吗？
雁僦雕狸狮坲_我是狗奴你是人渣 : 请国家多自助国内困难户和儿童。
1016奉 : 绝对男神！
HsiaoGrace : 就喜欢部长这么直白[心][心][心]
pOppY_就是那个灰辉微徽 : 愤青果然还是觉得外交就是简单的要么干要么散。照你这样早玩完了
Forever_小小睿 : 缤纷夏日，炫彩红包抢起来！！！[鼓掌][鼓掌][鼓掌][鼓掌]关注川商收藏品1808，就有免费红包领取哦。[玫瑰][玫瑰][玫瑰]小伙伴们，快来参加吧~~~
任灬爽 : 男神♪～(´ε｀　)
Dandanping : 最帅外部。
安之若素_1130 : 回复@yokokosu:自己国家被欺负再好的脾气也会生气[崩溃]
余诚涵 : 长得像一只生气的松鼠。。。
弄雨铃儿 : 男神~(≧▽≦)/~
顾_HY : 回复@谢谢理健:[微笑][微笑][微笑] 智障？
垚yao犇ben : 总裁范儿[good][good]
谢谢理健 : 呵呵，感觉王部长有点膨胀了，被娱乐的悲剧。
A叫我片儿杀宝宝 : 小心我老公干你哦[doge]
Palin_Dun : 回复@用户5304328915:你妈是[狗]
L--陌蓝 : 小日本，这样对你祖宗还想不想活了
HelloWork中美创业俱乐部 : 转发微博
那一年的長安飛花滿天_ : 哎  历史书上说日本这名字代表的是日出的国家？还是永不落的太阳？？哎哎真不好意思印象模糊不过南京大屠杀我记得挺清楚的  我给你解释一下吧 日本的意思就是欠日  看 就两个字 多好理解  不谢
坂本sama : 国家和偶像终于和谐了[哈哈][哈哈][哈哈]
来自火星的胖啊喵 : 现在国民新晋男神，[哈哈]
只要心够决丨 : 回复@喂龙用花生:尼玛给我表演灵车漂移，你爸在你面前直播草你奶奶，小篮子
仙人掌61019 : 流氓
哒哒哒49403 : 就是要这样。以前忍让是咱们好说话。没完没了就要给它点教训
敏儿不吃饭 : 好帅好帅[害羞]
yokokosu : 王毅明明是温和派 怎么变成这个样了？
爱穿高跟鞋的冯太太 : 奉劝日本，不要一错再错.没完没了！小日本和韩国狗腿子都欠收拾
_SGG0908 : 你来做大大。。。。
ZOKORU : 原来是日本政府给菲律宾3000万美金弄的仲裁闹剧，难怪不依不饶[哈哈]
薛之谦周边someone : 好喜欢
y莹莹姐y : 二皮脸又在做妖，有完没完了
狮子馨水 : 好喜欢外交部长王毅，人格魅力深深吸引着……
喜欢白色的明先生 : 回复@倪小Q:这样只会让事态更严重
金毛牌轮胎 : 1.我不是来约炮的；2.每个人都有两面性，都有一个不为人知的自己；3.现实生活中很多话题都没法去聊，比如性爱；4.生活中越是文静的人，对性爱的幻想越是疯狂；5.和陌生的人聊一些内心深处的想法，也是一种放松自己的方法。→_→有同样想法的女孩子，如果愿意的话可以私信我。
BIGBIGFACE大劉 : 好帅！[爱你]
又被煮了 : 这个听着就很舒服，要说不要瞎BB好像不太合适
梅氏艾思特 : 转发微博
阳光小学毕业生 : 小日本！管好自己快要沉没的小岛再说吧，真是把不要脸当作秀呢。
削个丶椰子皮丶你却他妈么给个梨 : 王外长：你，出去[拜拜][拜拜]
MEHINGCN : 该狠就得狠！
我愿君心 : 这话漂亮
孤魂野鬼xu : 日本狗真是给脸不要脸。
卡卡的地盘baby : 不要挑衅
J_COCOA_J : 外长退休了，去你母校当校长吧，为国家培养和发掘真正的栋梁。
王永琪琪琪 : 霸气男神呀
blue雨筠paradox氵 : 外交的实质就是强大的国力通过出色的外交官体现出来，帅气的王外长硬气。
策白马啸西风fyl : 回复@kevin-pmj:如果你不是中国的人，可以滚，没事整天多读读书，看看外国好还是中国好，中国少你钱赚了还是没让你吃饱？台湾好？你去台湾网看看多少人骂蔡？美国好？你看美国多少枪杀案？
我的世界只有你LJY : 小日本就是不打它   它不知道中国怎么写。
耳元__ : @Org_Lett
YF幸福style : 霸气的外交部长王毅
和松容尽 : 小日本，再狡辩，你不但是无耻，脸都没了。
jojo_claire : 日本人真是没完没了了～
爱大鱼真是太好了 : 回复@向沐宸:你再对我老公说这样的话别怪我不客气！
暖阳几厘 : 男神
tingzi-YT : 男神就是这么霸气[爱你]
ViViMK : 屁大点地方！ 说不定哪天就沉了！  还唧唧歪歪争这争那！ 不好好生活、  来调事端！  分分钟炸飞你[挖鼻]
Christine-Paris : 帅[嘻嘻]
倪小Q : 你倒是制裁啊！口头警告对于熊孩子来说有什么用？颁布法令不允许中国人去日本旅游，减少对日本商品的进口！
OnePeacham : 人民日报[doge]没想到你是这样的人民日报
立家几又NY : 是时候该出手教训一下小日本了
北京无损检测培训中心 : 就该是这样 霸气
阁主G : 被外交部长圈粉[微笑][微笑]霸气
缺缺310827 : 看到我毅转一转，我毅面对哪一国都怎么帅气
金牛县长 : 真不要脸的厕所人
大为知识产权 : [抱抱]男神
善良的亞非 : 男神
暑ING : 表示很嫌弃的手势
手机用户2565775435 : 支持王部长
时间是贼Dp : 霸气[笑哈哈][好爱哦][好爱哦][好爱哦][好爱哦][给劲][给劲][给劲][给劲]
时间是贼Dp : 帅气逼人[好爱哦][好爱哦]
时间是贼Dp : 萌萌哒[笑哈哈][笑哈哈][笑哈哈]
M花漾小妞 : 日本就是低贱的一个国家，在各种事中都尽力损害我方的立场，它从来不懂得安静做狗，如果有一天，它消失了，是再好不过的事情。
卡布咖啡馆 : 王大大威武[good]
顺电UU : [哼]王毅脸
筱泰王永 : [good]
疯鱼之川 : 翻译，别特么瞎bb。
杨蘑菇的姑姑 : 别他妈没完没了 信不信老子一枪崩了你[微笑][微笑][微笑]
ruthy2419888 : 真的是没完没了，贱人就是矫情
GAOYUANnnn : 帅
坏羊羊是女森 : 谨言慎行，一错再错，没完没了！我现在很崇拜王部长！
huahua_53376 : 王外长的话 一针见血
你不用记得我的好 : 回复@小嘿嘿闯:一个人一个看法不必深究[微笑][微笑]
我是你云雀冷sama : 看到王毅部长总能想起周恩来总理。[思考]然而对于周总理也没多少了解，但就是觉得像。
余天志 : [吐][弱]
功夫熊猫16809 : 王部长，帅气[赞]
你说我有没有小情绪 : 回复@LJ-ZZOO:真是不懂你这种人存在的意义。。。
奔放的小青年Owen : 霸气，就得兑他
蛤蟆227 : 这就跟警察抓小偷常用语一样“站住，别跑，再跑我就开枪了”，虽然没屌用，还是天天喊，有能耐你真来一枪！
我叫怪兽而已 : 对部长大人路转粉
壹個侑故事旳釹朲 : 政事我不懂……
逍遥一叟 : 对强盗早就应该端起猎枪！我大哥[威武]
文香识味 : @浪遏飞舟o德阳 @共青团中央 @四川共青团 @成都商报 
正传宝宝 : 转发微博
赵帅XXL : 回复@喂龙用花生:人家上次跟某国记者说的很明白，中国就是让这帮人有一口饭吃，别的事啥也别管。就像猪一样给你口饭吃，让你活着你就感谢吧。
TST刺猬鱼521 : 霸气[good]
山青水秀7H : 帅吗？我怎么觉得没啥男子气概呢？
天狼削个椰子皮儿 : 评论里酸只会打嘴炮不开战的，我也不说你行你上这种幼稚的话了，就问你真的希望打仗吗？战时征兵你愿意去吗？加税征粮你不会抱怨吗？打打嘴炮就能解决的事情你非要赔上那么多条命你对遗属负责吗？
我愿成为一座冰山 : 回复@LJ-ZZOO:你是不是个逗逼？我看如果发生战争，你就是卖国那一个
hw_南京游侠 : 翻译一下 : 关你屁事?
HELLO粘糕女士 : 棒！
P_yong佳 : 好帅，霸气
刘佳瑶_ : 表白王大大。[爱你]
啊qian啊 : 你有对比过高仿鞋吗，会买什么版本，看看这篇文章，少被坑。
四条臣 : 日本就会没完没了，只要它还存在。
肖肖肖你个头 : 够 霸 气！！！
Daisy夜未央 : 酷！
kevin-pmj : 回复@26岁年华:你吠得不错
kevin-pmj : 回复@策白马啸西风fyl:拿文盲当潇洒,可笑.以为全世界的媒体都是姓党吗?这样的国家居然还有人拥护,不是洗脑多高明,而是蠢蛙太多
空格空着不空白 : 我男神，说啥都对
丶滴儿 : 王毅蜀黍，帅！
一抹微醺 : 回复@迷糊de陈:呵呵 小日本就等着你出手呢 就想找个契机挑起战争 日本岛大部分的面积不适合人类居住了 你知道这意味着什么吗？ 内阁不顾平民游行抗议强行改了安保法最重要的一条：不准主动对他国挑起战争。你们这些只会逼逼开战的真的有想过战争的代价吗？想想40几年前的中国，深陷侵略战火中过的连狗都不如！
一扁轻舟 : 回复@喂龙用花生:超级技能，眼一瞪，帅吧，有毛用，可有人就吃这一套。
OMELSA : 没完没了。。哈哈 这是真生气了
自然向快乐出发 : 有你日本鸟事，滚一边去！
请勇敢大声的叫我韩哥哥 : 中国外交早就应该这个简单明了！[good]总是谴责有什么用[熊猫]
扶桑666666 : 王毅先生好帅啊
鲍伯兔兔689 : 我的新男神！！！棒棒的！！！
西贝蕾蕾 : 部长帅帅的，话说的也帅帅的！[good][鼓掌]
丝竹废很多年 : 洋洋乎战国纵横家气派
用户5304328915 : 回复@Palin_Dun:[微笑]狗一样的东西
一抹微醺 : 小日本一岛的核材料融化 不在别国找点事 怎么挑起战争 怎么去邻国再占点地？
迷糊de陈 : 可他们在搞事情啊，你咋办，还不出手？说说没有用的
-1ihao- : 说话要硬气，日本只是弹丸之国。
520Tiffanybaby : 奉劝警告的话说的太多了，中国该强硬还击了。别人日本根本就不吃这一套。
Miss罌粟- : 新晉男神！[good][good]
一个南瓜五毛钱 : 门口在那边
阿旭映像 : 有很多看热闹不嫌事儿大的，张嘴闭嘴就是中国那么厉害怎么不敢打什么的。[微笑]一旦打起来可能很多东西瘫痪然后啥都做不了想过吗[微笑]
鱼子酱Nie : 真的别再错了，你知道你们岛国生产的化妆品少了中国的购买力会怎样吗
情感语录集合 : 溜溜溜溜溜溜溜溜溜溜溜溜啦啦啦啦来冷了啦啦啦啦啦啦啦啦啦啦
面包要出走 : 打死你个龟孙
竹延爹妈 : 好想知道霸气的外长知道自己成网红了吗？
喂龙用花生 : 回复@只要心够决丨:你妈在我床上哼哧哼哧的
其实是布丁 : 明意就是：不要给脸不要脸
李沐宸喜欢炯炯 : 小日本真是事多，王外长说的太赞了！
貔貅说饕餮丑爆了 : 在下奉劝一句，阁下不要一错再错，没完没了，对付无赖我有的是办法！
只要心够决丨 : 回复@喂龙用花生:你算个JB
hfcjyfnnitfnk : 回复@源氏物語110:不要说中文啊 对不起你美国爹日本妈
-Xy-Shero : 男神 太帅了[心][心]
洋气氛 : 想去怒斥记者中的人均收入八千....我默默的关了视频哭晕在厕所。是我不懂事不好好挣钱拖了祖国后腿影响了祖国富强
伊婉爽 : 不要去日本旅游，去南海旅游。肥水不流外人田。
露上结果 : 日本像是不听话的孩子 何时他们才能迷途知返[怒骂]
喂龙用花生 : 最近微博微信上各种各样的文章捧王毅，我想说：外交部长是干事儿的，不是看脸的，长得帅可以去演戏。除了会跟记者发飙，这哥们儿这几年正事儿干的真不怎么样。
J江大脸 : 回复@TsingHa_:有一个怒斥记者的视频～～太酷了，很解气
那个那个裴 : 小日本没完没了，[愤怒]
pinkcat粉猫达人 : 为什么日本从古至今还是一样jian[哼][哼]小小的岛屿那么不老实，
Yohoo__Lin : 回复@孙喵喵还是孙猫猫:嗯[微笑]
竹子废材 : 回复@Sylvia__a:[doge][鼓掌]
-Sanateth : 男神啊男神～
闲来看水流 : 回复@小正太暖洋洋Baby:你还可以骑我baby。
丫丫学步_29636 : 帅且霸气的伯伯[good]
LInJIeYInG- : 我被外交大人的气场震慑到了，[鼓掌]
艾琳MIN : 霸气[good][good][good王外长就是国帅][鼓掌][鼓掌][鼓掌]
不是拖延是剩余时间乐观症的谷雨 : 怎么感觉日本最近总在哔哔叨哔哔
我是黄亚兰 : 回复@丶瑶玲啊瑶玲:只看国产和巴基斯坦黄片[微笑]
叫我男神就行 : 真帅！
shanyunqu : 外长我男神啊啊啊啊啊啊啊
霸气我爱我家-55 : 霸气老本给咱老王家长脸
啦哩啦嘞噜 : 外交大人可以做一组新的表情包了
1990年2月7日 : “与世无争”？想到了汉朝的“无为而治”@意大利足球新闻:中国的历届外长没一个怂人，只不过近年来我国国家战略开始转变，结束了与世无争的修养状态，从不争变成了争，外长也就跟着硬了起来。
镸弓聿 : 霸气，儒雅，潇洒，帅气，铁骨……文化低，只能想到这么多……
Lee小花吖 : 男神
AISILA牙齿冷光美白仪V : 新晋男神
李琳呀- : 喜欢这么言简意赅的官员[doge]还可以更简单点：你特么少给自己加戏
临沂李官 : 霸气
绝对领域刺天使 : 转发微博
遇见3124802265 : 回复@闲来看水流:你是日本人吗？
婲落爱未央 : 男神男神
猪猪ing2013 : 太帅了，偶像
楼强强从来没有认输过 : 男神男神
barney_张乐康 : 硬炸天际，男神典范[闭眼]
王木木zHU0220 : 霸气。支持[心]
k-ris : 就是罗，没完没了，烦都烦死了，每次都要说同一句话，日本不累，中国都觉得烦
YANGha哈 : 霸气王[心]
草莓小姐的心愿 : 大写的帅！
oO青春撕扯流年 : 给王叔点赞
UV无影手 : 跟豺狼讲道理只有用猎枪
策白马啸西风fyl : 回复@kevin-pmj:以前中国外交官动不动抗议和谴责的时候你们骂，现在说话有底气了你还骂……脑子进水了吧，连中外记者都说王外长是个随和尔雅的人，怒斥记者是因为记者不实报道，刻意刁难
黄金相 : 中国对日本除了口头警告还要有实际应对
草药姐 : 王毅是男神[心]
嗷嗷先森azn : 钓鱼岛怎么没后续了？
Crystal_teacher : V5霸气的王蜀黍…[爱你][good]
王越越越变成了托福狗 : 王毅真的有一种高干文里写的军队大院出来的外交官的feel 举手投足都是气势阿 三代出贵族里那种修养极好还颇有个性的男人
水洗_柑橘 : 看你长这样子 可否公布一下子女所在地，以及财产情况呢
帕丁顿的熊 : @-unbroken- 王之霸道
鑫鑫鸿基 : 臭不要脸的日本倭寇给他两巴掌
学生西华 : 日本[打脸]，卒。
密码是多少都不行 : 下一句，否则，我瞪死你
ET张公子 : 瞪瞪眼可以，瞪三下给你戳瞎
發財發財你好 : 买芒果干的，请出去。
陶陶桃啊 : 表白小龙人！
洛浅丶Syn : 外长霸气[鼓掌][鼓掌][鼓掌][鼓掌][鼓掌][鼓掌]
宝贝妮子9020 : 男神[好棒][好棒][好棒]
抗日老兵新遭遇 : @抗日老兵新遭遇: 我老爸在辽宁省盘锦监狱离休，他参加过抗日国共内战和抗美援朝等战争，但在1981年，我老爸的抗战履历被中组部下个确定参加革命年限的认定文件，并在盘锦监狱组织部在没任何事实依据下，给予我父亲“有错误”的认定后，剥夺了我老爸的抗战履历，这是构陷和乱作为！
GG肥肉 : 学医救不了中国人
Ya_ing : 大量书籍转让，各类型都有，医学风水算命偏多，都是自家保存完好的，都有95成新，绝对正版。还有大量线装书，有兴趣可以私信。成批单要都可以。
胸不大的姑娘 : 国家强大了，自然说话底气足！
殺手很酷 : 安安静静的一座小岛多好，非得沉下去[怒]
淤泥为了省略 : 我男神还是辣么帅[微笑][微笑][微笑]
十八子元祥 : 我想知道日方说啥？
小嘿嘿闯 : 回复@你不用记得我的好:周总理兼任外交部长，你可以搜一下[微笑][微笑]
翻炒弹201605 : 欠抽的鬼子政府！！我继续抵制[doge]
鄂尔vito : 我男神
小饼脸soso : 就该如此霸气
隔壁老王WKW : 不怒自威！终于知道这个成语形容谁了
聪明的miumiu : 王毅爸爸说的好！
失足少女闻吹吹 : 哈哈哈 新任男神
Listen-RN : 赞一个[good]
Will2003年 : 我觉得王毅太帅了，是真心帅，当然他讲这些话就更帅了哈哈，说实话日本其实是一个很不错的国家，但是作为中国人我一直接受不了这个国家
用户3i1cr3fklj : 回复@吼批王 的赞:亲，谢谢啦！.
BC沙恩霍斯特 : 好！
LYLLYLLYLLYLLYLLYLLYLLYL : 建议国家领导人也要有自己的私人微博 以便于我们追星[馋嘴]
玄关一朵蔷薇 : 中国一点都不能少
烯泽欧巴- : 别给你点阳光你就灿烂，还蹬鼻子上脸咋滴，回去好好发展av事业，给你中国爸爸欣赏得了！
26岁年华 : 回复@kevin-pmj:美狗日杂汉奸滚一边去吠
用户3i1cr3fklj : 很好，对小日本的胡搅蛮缠，无理取闹，是应该给予严正警告了！
陈杰76990 : 日本人跟美国人一样，就是想把中国经济搞垮，日本人就是想在亚洲称王称霸，美国佬也是一样，所以中国想要跟美国开战，那就必须先把日本消灭，
用户d5ge55raog : 加强备战干他
大S孫啟平 : 此说的太有力咯……如果执迷不悟的话。来个经济制裁…日本就要内乱咯[嘻嘻][嘻嘻][嘻嘻]
冬知阳光好 : 想扼制中国发展
南宫优优 : 回复@你是年少的欢喜ow 的赞:[作揖][作揖]
麦兜兜不怕千万人阻挡 : 嗯
kiki-唐芳芳儿 : 回复@遁入六棺:就是！[握手]
不走菊花路 : @_Sarena_   老男人
Honey_Xenon_Money : 王毅大大做得好！以及评论里一堆智障，脑子是个好东西希望你们都有。
烧烤冷饮设备15729362609 : [good]
红色珊瑚梦 : 就是，给脸不要脸的，不要再没完没了了
小小小小凉薄 : 王男神:你们在BB来BB去，我的粉丝团可不是吃素的[doge]
并卅龙城 : 王毅外长给中国没少长脸。
肿了脸的胖子黄 : 王霸霸好厉害[good][good][good]
kevin-pmj : 代表中国的外交官,动不动就怒斥记者,这和小痞子干架有何区别?一个流氓政府下的流氓代表.
一只甜甜的丽宝 : 奉劝你个卖av的不要多管闲事[害羞]
天使在我心ZY : 霸气
shinichi新一兰Ran : 新晋全民男神
Sandy_babe : 刚刚还在热搜50，现在就没了
Mr吴9 : 男神上线
我是猴哥呀啊哈哈哈 : 就是，不腰没完没了。你可知道你面前的王男神背后有一大国的粉丝团[doge]
Sandy_babe : 好样的
加油吧0张聪聪 : 看我男神就是这么帅
熊明忠 : [吃惊]
用户8h7nc6wycr : 就是要有这样的人来维护我们安稳的生活，抱着感恩的心，谢谢您。
小正太暖洋洋Baby : 回复@闲来看水流:就应该欺负你这种傻x
123456平安快乐 : 痛斥日本小人嘴脸，[怒]
张籽沐M : 日本真是不要脸[doge]
抹茶味的赵慧 : 太帅了  [可爱][鼓掌][鼓掌]
枕边书yy : 男神V5
陈杰76990 : 日本是亚洲最坏的，经常跟中国有仇恨，扔原子弹把日本夷为平地，操他妈的，
二月红红不红 : 我们不报复，不代表我们不记得。
你说东我朝西 : 门在那边。
ATANEB : 哇哦~帅啊！！！！
等到风景都看透811 : 新加坡不是好东西！
定海小神棍 : 大大帅[good]
陈杰76990 : 把日本人消灭掉
SchroDingerSCAtt : 讲真 那种说有一种新闻叫国内新闻的人去过国外吗[微笑][微笑] 搞得好像自己懂很多一样
普珠扎先生 : 不服就干，弹丸之地敢于日月争辉。 为王毅外长点赞！
猫哈哈吃西瓜 : 王毅超有气场和威慑力! 不怒自威! 真的有大国风范!
戴温崎 : 光打嘴炮有什么用？中国不照样刚签了什么狗屁南海宣言，还他么承诺不在自己的岛上做任何事。有什么好高兴的，继续意淫吧
慧ny- : 就是要打他们的脸！
小蓝毯 : 回复@遁入六棺:打仗真的这么简单早就打了，脑子这东西希望你有[微笑]
澄心无澜 : 图配错了！！要配翻白眼蔑视的那张！！！
颖沥川 : [good]
一只不愿透露姓名的米少女 : 王蜀黍迷妹路过[爱你][爱你][爱你][爱你][爱你]
淡泊小舍 : 卑鄙小日本
Commesssi : 没完没了！
大爷我起个名字真他妈难 : 大致意思是对日本说：你TM别给脸不要脸
淡水里的海绵 : 回复@向沐宸:你要弯了
Yolanda-HH妍 : 回复@捉鸡逗逼:[笑cry][笑cry][笑cry][作揖]
有洁癖的拖延症 : 欣赏王部长
木签丶 : 最近王毅王大大，用词好解气啊，没完没了，哈哈哈哈哈。
王梓阳20999 : 卖香蕉的都不说什么 你拍AV的瞎掺和啥
Allytheninja : 日本岛总有一天震沉了。。。
TOP么么哒的喵喵媳妇 : 男神[心]
遁入六棺 : 回复@kiki-唐芳芳儿:虽然我也认为中国一直在打嘴仗，没点实质行动（不是武力）。但我真心觉得王部长和驻美记者王冠的反击非常精彩，做的非常棒，就该态度强硬，日本本来对于南海问题就没有话语权。
闲来看水流 : 大日本你也敢惹，欺负国人行，大日本不好使。
丶瑶玲啊瑶玲 : @我是黄亚兰 王之蔑视 卖av的请走开[喵喵]
脊梁Sooc : 回复@fly多啦A梦的猫:那还是不刷的好
待金林 : 滚蛋小日本什么玩意儿！
王蒙--- : 回复@呆萌的壞壞的蜀黍:我们没有这个不孝的儿子[怒][怒]
coccooccc : 以后粉丝就叫一家人吧[色][色]太帅
哪个谁叫你呢 : 真正的男神
藏御源牦牛肉 : 王毅 真帅
云南罗王保 : 好好[爱你]国土主权绝不退让
左岸观灯 : 奉劝？你是上帝吗
其实我是可口可乐啊喂 : 很好，这很硬气[doge]
准小基 : 男神[爱你]
colin90618 : 回复@LJ-ZZOO:维护国人利益也有错？不该正义？拜托，不要因为自己是个平民就肆意嫉妒别人！
淘汰gentleman : 卖香蕉的走了，小电影就来了[拜拜][拜拜]
_穿过森林的大海_ : 有祖国才有家庭！
_方南的丽美_ : 不然呢
我是小柒呀 : 回复@喜欢烊烊的孙同学:有兴趣加入千玺公主站么，旁友[眼泪]
先生不放弃 : 回复@同学王云:啊.王外长是你老公啊.看来妹子是想找当大官的男人了.可不知妹子现在多大有无老公.别让你现在老公知道打你.
炫铃用户3153629024 : 男神[doge][喵喵]
不关心天气预报 : 666，就要这种，惹到就要打人的气质。
买浪味仙送吴世勋 : 男神[good][good][good]
DHV张小爱 : 我是米妹。求关注
詠笎銪茤笎 : 回复@上来一个嘴巴子:那人脑残不用理他
张贝贝BellZ : 别没完没了[doge]
情到深处不能自拔 : 中国的领权不容侵犯
七杯美咖double糖 : 有些公知真是够了，平时该讲道理的时候以自我为中心，这时候缺出来讲一大堆自以为是的道理，自以为众人皆醉我独醒。
黑色的墨了 : 相由心生……
名字都被用了了了 : 新男神
爱喝橙汁的圆滚滚 : 王毅大大说:NTM再逼逼，甩起来就是一耳光。。。
思明博警 : [好棒]王毅：奉劝日方不要一错再错，没完没了[good]
Xpinky33 : 男神
回忆也不属于我 : 男神
fly多啦A梦的猫 : 回复@脊梁Sooc:打了你就刷不成微博了
刘某小珏子 : 棒棒的！！
用户5894330404 : 简直没完没了，忍无可忍
果妈麦子 : 真的很男神，那眼神没谁了！
城鹿 : 太帅太帅[哆啦A梦花心]
阿拉丁200 : 只有国人团结一致，国家综合国力的强大了，国家主权才不会被侵犯。
A赵开森 : 霸气，[good][good][good][good][威武]
A赵开森 : 回复@向沐宸:你是男的[doge]
_小笼包子丶 : 外长威武[心][心]
rukezhi : 回复@LJ-ZZOO:脑子有屎
脊梁Sooc : 打吧，只要是一味求和的国家全部灭国了
逗比的白衬衫 : 有脾气
爱吃肉的程序猿 : 日本就是这样的，，，没脸没皮，，，
左丘茗 : 男神男神[可爱]
黑qio : 日本这个国家，这个民族应该亡国灭族
LLLL_199704 : 好帅好帅我们的王部长，威武[鼓掌][鼓掌]
你的房东哥哥 : 回复@LJ-ZZOO:Loser
有爱心的人会有人爱 : 日本人就是倭寇。不讲理。喜欢侵略其他国家。没人性。和没道理讲
咖啡豆格子9216 : 硬气
受过的伤-都是我的勋章 : 日本就是多管闲事
上来一个嘴巴子 : 不知道热评 说 公示财产那个是什么意思。
eclosion1 : 轰炸小日本
薛闯CC : 挺帅的，日本帅不过他
土匪老顽童 : 新晋男神！！
简小白就是本宝宝啦 : 男神 我是你脑残粉！
久安若-ballet : 男神魅力值 啧啧啧
-丁月梅 : 日本不要一天到晚插手别国的事，多管管自己家事，也许就不会出现砍人事件了，要反省[挖鼻]
不晓得为啥子安59467 : 小日本就是没有被收拾到，跳完了
茜茜爱吃零食 : 霸气总裁。
卖女孩的小火柴0304 : 王毅真的太帅了 不仅颜值高 而且对外不卑不亢 发言以理服人 简直棒棒哒[爱你]
米小雪666 : 哈哈哈
P树EV7BK18291 : 岛国人民应该多关心关心苍老师。一元易宝
哟嘿哦哈几酱嘉嘉坨 : ！！！！
sunnyclear1989 : 王毅大大[心]
孙喵喵还是孙猫猫 : 回复@Yohoo__Lin:历史书要好好看！[微笑][微笑][微笑][微笑]
Linshutian : 还是那么帅！
这始于一个古老的传说- : 霸气！新晋国民男神[爱你][爱你]日本不要多管闲事，没完没了，不知好歹！！！
Loteaf : 气场好强大[羞嗒嗒][羞嗒嗒][心]
围i围 : 霸气！
__Leonn : 大耳刮子抽丫的
嗄日微阳 : 没错，不要没完没了了，日本还真是
卖蘑菇的小包子_Jessic : 就是辣么帅[微笑]
小璇儿是多面体 : 外交部的硬气来源于中国外交战略的改变，支撑外交战略的是祖国的强大！
空间策划者 : 必须顶起来，我爱你，男神
SincerelyLH : 部长霸气[赞]
Perng-young : 一错再错步步错，关你屁事。你干涉别国内政。
闺蜜都叫我Ren妖公主 : 回复@LJ-ZZOO:你有什么资格让外交部部长公示
傅浩莹莹 : 帅爆了[亲亲][亲亲][亲亲][亲亲][亲亲]
Grace暖明月Way : 哇哦 男神又出现了！
等待美美地 : 新晋男神王先生
老邪的抽屉 : 奉劝不要一奉劝再奉劝了，没完没了
金月月韩 : 天团男神
People-l : 我单方面宣布王外长是我干爹[doge]
慢热伴侣 : 大写的帅
Mascara_forever : 好!
清水迎茵 : jap
大梅子慢慢来 : 没完没了……没完没了……[哈欠]
song_xiaoyi : 对日本别手软
葉FDom : 贱样就那样，谁强服谁，狗仗人势
肆了个肆洞词达次轰丶 : 外长大人~~[色][色][色][太开心]
泠泠笑音 : 屌屌屌
black_格格 : 日本是借南海这个问题跟美国站在一起 顺便收拾中国 太有心计了
lisayerRed : 日本，回头是岸呀
147嗯 : 我王大大[哈哈][哈哈][哈哈][哈哈][哈哈][哈哈]
惠喵官网 : 转发只为天团男神！[good][good][good]
Seaaa_WU : 男神威武[酷][酷][酷]
不要叫我雅蠛嗲 : 你他妈没完没了了，到时候中国真的发火了，你就后悔那么嚣张了[哼]
思佳小主 : 高中我努力学化学的原因就是想做个炸弹把日本领导人炸了[眼泪]
清风徐来的约会 : 666
1anCeLot : 再没完没了叫我大兄弟去北方四岛飞一圈
滕___ : 别没完没了！
LAWKINGMAN_ : 听我男神的 别没完没了 还要bb[拜拜]
冠泽先生 : 又被部长撩到了！有木有！
Sylvia__a : @是谁要毒害本宫  @竹子废材 国家面前无偶像 最男神[微笑]
南宫优优 : 回复@用户5864074728大圣归来 的赞:[作揖]
进击的吴憨憨-Amo : [doge]单方面宣布，我有一个王霸霸！
眉安都督 : 小日本，天这么热，哪里凉快哪里呆着去，这事太大，不是小孩子瞎掺和的！大人玩的游戏，小朋友就不要玩了！你还太嫩！
南宫优优 : 回复@瑷笑滴眼睛 的赞:[作揖][作揖]
我Joe阿 : 看热闹不嫌事大，日还非要无故硬挤进来
夕漫_SoSo : 如此率真boy
今晚打老虎hp : 日本狗性永远不会变的，把战场在日本本土开战吧
范青同学 : 就是这么霸气就是这么帅[心]
FAnnnnxx : [兔子][兔子]@是朵朵不是朵朵D 酷诶
永恒紫电 : 完全不想和你谈 找你大哥出来谈[ali哇]
G-T薇 : 男神霸气[good][good][good][good]
麦_琦_琦 : 我就觉得奇怪，日本人对自己的卫生巾国旗一点都不觉得不好意思么，我每次看到都这么想
hang_tt : 我男神就是霸气啊，好想把我儿也培养成这样的男人啊[哈哈][哈哈][哈哈]
之最i : 我的父亲于15年7月给私人打工干活，在雇主家经高温中暑死亡，具体情况我和家人不得而知，现在还在打官司，法院一直在拖。我的母亲3级残疾，本来就贫穷的家庭因为父亲的死更惨淡，家里剩下我14岁还在读中学的弟弟，和没有劳动能力的母亲。还有一个70多岁的奶奶，现在她得了脑瘤在医院，我不知道该怎么办
孙可爱www : 其实外交部态度这么强硬，虽然给人感觉硬气，挺好，但是也是有坏处的。
隗小卷 : 棒棒哒[鼓掌][鼓掌][鼓掌][鼓掌]
吴伟林僾笑 : 帅出新高度
卤饭爱吃卤蛋 : 别没完没了的[挖鼻]
啊hahahahahahahahahaha : 显然日本就是没完没了，我们应该怎么办呢？
小丫小公馬 : 一年前，有个人默默的赞了我一下，现在他名利双收。
Vayne丶Riven : 回复@Palin_Dun:看到评论这么多人骂你我也就放心了
罗思明Nik- : 回复@赛米爸爸:我们是持着，真话不全说，假话绝不说。的态度，相信祖国！
用户5445524300 : 就会嘴上说说
想嫁给声妹的胜铉迷妹 : 卖AV的请出去[微笑]
南宫优优 : 倭寇就是天生的一肚子坏水！所以说，我们不仅在心里、口中鄙视倭寇、抵制日货，更应该体现在行动上！不能嘴上喊着爱国，行动上还去日本旅游！前几天看报道：湖南卫视离任当家花旦LX一家、演过狼图腾的F姓男星带着小新欢依旧去日本旅游！他们都是给日本建造攻击我国的武器送钱呢！呜呼！不争气的国人啊
joe约翰文 : 简直男神，我以后也想当外交部[眼泪]
陌上暮晗迟迟归 : 王之蔑视！！！又来了！！[赞][赞][赞]
leilei_1024 : 王毅，赞赞赞
崔司机的迷妹 : 这很王霸霸[good][good]
晚睡的油头怪 : 终于不是强烈谴责了！我喜欢[给劲]
李丸纸 : 再填一个压压惊
关小琉 : 还有句话是：自己的历史都不干净~大概意思是这个，我记不明白了~
平安423 : 【认当美国的三孙子，小日本鬼子】
说苦不苦的memory : 王毅大大,开个微博好不好？我粉你[加油啊][爱你]
心有林夕LRX : 回复@向沐宸:惊现基佬[哼]
L_monica : 闭嘴[生气]别逼逼[挖鼻]
陌上新榆 : 没完没了……哈哈哈哈哈[哈哈][哈哈][哈哈]好像一个特别难缠的女人被一个男人骂不要再纠缠我了……
郁文堂 : 最新网红！帅！
李小先森丶 : 帅的能追上周总理的背影了[爱你]
U尐艳 : 上海急找租客 因原租客移民 现急出租本人一套静安寺精装 距离地铁五分钟 两室一厅 电梯房七楼 拎包入住 2500/月 可以合租 押一付三 联系人：范老板 130-0219-2759
赛米爸爸 : 我们一直在奉劝一直在谴责一直在关注。[拜拜]
成為室內設計南 : 能Bb尽量别动手，动手以为就简单的打架？是会死人的，
明明就是羡慕别人的呀 : 回复@LJ-ZZOO:做实事的官，贪又如何
一个冷漠的小削饼 : 我滴亲学长啊[心][心][心]
四月的白yang : 回复@LJ-ZZOO:公示尼玛币的财产
小万万512 : @大大大大唯
流水险险 : 很喜欢普京的一句话：“领土问题没有谈判，只有战争！”
Molly_茉莉公主 : 翻译真的会照实翻吗[挖鼻]
藤田已州柳 : 深圳市宝安区福永街道白石厦村委把福永社区白石厦路6号—108号路段，马路中间画成3米见方的方格，出租给乱摆卖，露天烧烤，乱摆卖一个月收取商户600-850元不等，露天烧烤每月收费商户1200元，乱摆卖每天下午17:30分准时出来占道白石厦马路，节假日全天24小时占有白石厦马路，每天搞的垃圾遍地烧烤的烟
菜菜菜不够 : 啊啊啊～好帅
慕清绾Transparent_ : 没完没了，真是绝了
zhizuchouchong臭虫 : [赞][赞][赞][鲜花][鲜花][鲜花]
-米色lili : 偶像
limIreneee : 哈哈哈 霓虹别再碰瓷蹭热搜了好吗[微笑]
何曉樑Flank : AV国又xbb了 三天打上房揭瓦 真贱
南宫优优 : 倭寇们就是天生一肚子坏水！
SylviaGHQ : 男神出现[哈哈]
helaer呀 : [强]
Haru_Monsant : 帅！
想要飞翔的汤圆 : 可以，这很王毅[good][good]
待定14 : 有些时候就是该这样解决问题，不给点颜色瞧瞧还以为我恁好欺负，
你才是神经病aha : 霸气，就该这样直接开门见山
王花花花花小妞 : 男神好帅
向日葵_在樱花盛开的夜晚 : 外长帅气[doge]
酒轻 : 男神发话了！[兔子]
PUPPETAXI : 没完没了哈哈哈[开心]
cattybear_肉肉琬 : 霸气！
来废话 : 劝日本吃点它们的特产处女屎冷静一下
2199zxx : 男神[赞][赞][赞][赞][赞][赞]
佳佳你还记得吗 : 回复@LJ-ZZOO:傻叉
东迷丶 : 我用方言翻译哈： 小日本莫讨嫌，莫犯贱，再鸡巴跟我妖艳儿，老子飞起都是一 jo
陈陈陈陈陈家琪 : 门在那边，自己滚[拜拜]
幸运电脑007 : 跟他提都不提，因为它没资格讨论
Palin_Dun : 回复@一只好鹅:智障
loveyourselfBIGBANG : 评论里有些智障，我们就不要理他们了，跟他们说也说不通，自己有能耐自己上去啊，在这里说有什么用
改名这么难咋不上天呢 : 霸气[心][心][心]
_曾靖 : 男神外长
Lazylzzy_tttop : @一只绿油油的西瓜
Play-Man卐 : 没完没了的小日本[doge]
-Lavender_颖 : 干得漂亮[强]简单明了，要的就是这种态度。
一只好鹅 : 回复@Palin_Dun:那你他妈上战场啊 [doge][doge][doge][doge] 去吧去吧 人家解放军私底下的努力估计你狗眼看不到 那就你来践行吧
啊呀呀呀呀呀牙牙 : 日本，大人的事，你小孩子少管，先管好自己吧，小心哪天就没了[哈哈][哈哈][哈哈]
LaI_Bby : 喜欢那个没完没了哈哈哈
大唐花开 : 终于不含糊其辞了，可以警告那些找事的国家了。[微笑][微笑]
月出东阁 : 日本就是臭不要脸
燕子xia : 这个时候，我想念周恩来。
谢诗诗诗ss : 手势：这边有门，多管闲事的从这边出去
茂林的小太阳 : 回复@Palin_Dun:[微笑]你还是关心下你自己的脑子和智商吧
Manyyearslater-- : 这个手势：卖A片的出去[喵喵]
Oddoldi : 总是用奉劝这个词，太老牌，跟不上时代的语言特色啦！
_毛毛虫虫 : 女生就喜欢这么硬的[doge]
一只好鹅 : 这条评论下汉奸们还是不少啊 居安思危啊朋友们[doge]
Venus-Ljx : 回复@Palin_Dun:那你是要把唯一一个大国邻居给得罪是么？你什么眼界啊
忠政票务_宁波专业回收购物卡票 : 对这种国家就应该用这样的语气，日本是一个最卑劣的一个国家。一大和民族是一个低贱的民族。[doge][doge][doge]
Victory刘宇芝 : 果然霸气，就应该需要这样的声音[爱你][爱你][爱你]
七百年后-oyasumi : [doge]别没完没了
佛爷佛爷我们去哪里呀 : 不要没完没了！！！霸气！
齐康鑫1999 : 帅气的部长
Epoon : 仲裁结果对中国无任何拘束力，这一点确定无疑。我们不能让一些力量“拿着鸡毛当令箭”。一纸仲裁就想拿走中国的海上国土和权益，这太可笑了。
Cherry-kysai-ai : 看见菲律宾和日本这态度转变 祖国应该在背后默默做了很多 爱你
小蚊子-honey : 南海问题到底解决了没有？
Venus-Ljx : 回复@Palin_Dun:你没看懂我的意思
晗晗的小螃蟹 : 帅气的男神。小日本儿靠边站
夜不语掌柜 : 南海关姨妈国什么事？狗拿耗子么
果子奈 : 不要一错再错 没完没了
一个非常硬的人 : 回复@M谭点点M:很个抛！
Palin_Dun : 回复@OwenRommel:可笑，你以为拍电影呢，昔日的敌人变成了今日的战友，好温馨的画面哦！
耳东家的女子 : 真的是帅的不像话了[哈哈]
源源Neal : 王大大[抢到啦]
新街口张江男 : [伴我同行]@布鲁公子: 转发微博
MAHannyAo : 可以 这很王毅
天嘲外传 : 无意义只有利益
爱吃鱼的齐小姐是双鱼座 : 听部长的[怒骂]听我男神的[怒骂]别没完没了[哼][哼]
九大大是个好男人 : 日本什么事不管？是想从岛国变成海国吧？
Yohoo__Lin : 回复@孙喵喵还是孙猫猫:可别说1949年后，你说1978年后还能相信
艺术张虹 : 现代战争还是需要的！[赞]
Palin_Dun : 回复@Venus-Ljx:哼，不是说努力么？
XLWB就是屎一坨 : 和提线木偶的嘴如此相似
MicalHurry : 日方，请你尊重你自己的国家，不然的话真怕你国旗上的红圈圈变成五角星。
好名怎么都让猪用了 : 回复@Venus-Ljx:兄弟，你的观点我很支持，那哥们确实胡扯，但是有一点，我查了维基百科，南海的西沙群岛和什么来着在我国控制，南沙群岛等控制权复杂，多国都涉及
戴帽子的烤鸡 : [good][good][good][good]
我的锁骨能养鱼 : 咋没人喊 脑公了[笑cry]
OwenRommel : 回复@Palin_Dun:我的历史不需要你教，谁他妈不知道外东北和外蒙古？但南海问题俄罗斯就是真真切切的支持中国，在目前的国际局势下团结俄罗斯对抗美国是最好的策略，而不是盯着历史而忽视现在利益
Nick_盛 : 老子要打击的人你也敢帮！[怒骂] 想死吗？
XLWB就是屎一坨 : 回复@Berry-be:估计你妈也乐意被他操[哈哈]
浅_爱_依赖 : 男神[爱你]
未_攸川 : 日本就是狗拿耗子…跟他们毛线关系都没有。钓鱼岛是中国的！
梦洋同學 : 能和平解决都不要动武真的，真要是打仗了，受苦的还是百姓！！！劳民伤财[泪]
TST庭秘密活酵母总代微namei0727 : 美男子
Palin_Dun : 回复@OwenRommel:拜托，俄罗斯对中国的友好程度没有你想的那么好，某种程度上说，俄罗斯是侵占中国领土最多的国家！
爱美丽鲜花坊 : 应该和日本扯开手干一场，妈B.鬼子不收，难消心头恨。
低调的孔雀2 : 回复@格格尼ni桑:朝鲜人一直很牛逼，至今无人能超越，不过也快被人超越了
忆昔开元全盛日天下朋友皆胶漆 : 不敢和中国正面肛 当个只敢狂吠却连咬人都不敢的狗 日本政府啊 你们就不觉得丢脸吗
已瑰 : 我现在最厌恶的就是韩国领导人阶层。可能是因为日本领导阶层一直都是那个鸟样。而且重点是，韩国百姓也是各种瞧不起中国，反倒日本民众的这个方面相比韩国好。所以韩国已经成为了我最讨厌的国家，没有之一。不过剁手也是在韩国[泪][泪][泪][泪]我要克制！
青豆6792 : 王毅长的真是俊俏啊，好会化妆啊[doge]
海洋木子李 : 中国对待日本能不能以其人之道还治其人之身啊！！
A小小小小瓶盖 : 把前排全赞了一遍
丨王世子丨 : 那个谁，过段时间把日本收复回来，自秦王派500童男童女去蓬莱求药至今，都好几千年了。这是历史事实吧？是吧？
Venus-Ljx : 回复@Palin_Dun:在你抱怨之前，想想为什么他是老板你是搬砖的，或许他爹是老板，你爹又是搬砖的，又或许他爷爷是老板，而你爷爷还是搬砖的，富人往上倒，总有一个是穷人，他是怎样从穷人变富人，总有原因
低调的孔雀2 : 感觉现在这个时代武器好不好无所谓了
取个名字都那么难草 : 小日本侵略都干得出来，还会怕警告？
猫咪的胖狐狸墨色 : 虽然你是只苍蝇不爱搭理你，但你真的很烦，别逼我去拿苍蝇拍
薛之谦的哇哈哈 : 霸气侧漏[喵喵][喵喵][喵喵][喵喵]
Palin_Dun : 回复@Vayne丶Riven:慢走不送了
唐遥1995 : 外长霸气
Vayne丶Riven : 回复@Palin_Dun:没功夫和你在这浪费时间，再见键盘侠
格格尼ni桑 : 中国强大了就是好，之前看政治新闻的时候，没见过，态度这么强硬的，说话这么牛逼的哈啊哈[good][赞]
Palin_Dun : 回复@茂林的小太阳:智商和脑子，你有就好了，我不缺，
夏秋57 : 最近中国怎么老是被苍蝇盯上赶不走了还？妈的，这是要被逼着发威的节奏么？
家有小宝and豆豆 : 咋了爸爸
lululululululuhan_ : 我校友[噢耶]
Palin_Dun : 回复@Vayne丶Riven:那你得先把该下的拉下来，我才能上
茂林的小太阳 : 那些台独的就别在这比比了，据说有个人拿着湾湾护照出去吧，联合国都不承认你们所谓的台湾国，这不是自己打自己脸么！还有那些说打仗的，打仗吃亏的是老百姓，还会让经历落后，要是真打起来，那些说打仗的还不知道躲哪儿去了，出门都带点脑子，脑子是个好东西，别让这些人笑话你！[鄙视]
OwenRommel : 回复@Palin_Dun:俄罗斯沙特阿拉伯印度表示劳资原来都是可有可无的小国，六十六个国家表示你眼瞎了么，也许他们作用有限，但新闻报道也不应该直接无视[微笑]
清潭殷小仙女 : @崔氏wxy
Vayne丶Riven : 回复@Palin_Dun:哟，还来个明白人，你行你上啊
Palin_Dun : 回复@Venus-Ljx:那就待宰喽
雪山鹰飞 : 小日本欠扁啊
Palin_Dun : 回复@Venus-Ljx:我很努力啊，都是在搬砖，别人一天搬一百块，我每天坚持搬两百块，老板一块砖没搬，我很努力吧！对资源的分配权，永远比对资源的使用权要大，你才能拥有所谓的财富和地位！
跟我学修车 : 开战之日，就是战败之时。几个小时就全军覆没了。
潘-大美 : 部长，用眼神杀死他们
我是大邵 : 说得好[赞]
小小至秦 : 面霸
VirgoMercury : @芹子加贝 王部长从南海火的不要不要的[doge][doge]
茂林的小太阳 : 回复@Palin_Dun:真打仗的话吃亏的是老百姓，如果真打仗的话，你还不知道在哪儿躲着呢[鄙视][鄙视]我看是你只知道打嘴仗吧，说话带点脑子和智商，这都是好东西
小妍子在各个圈游荡ing : 看见男神点进来的我不是一个人[偷樂]
valentia_chic : 男神发话，小日本跪下！
丶咖啡混柠檬 : 王毅不仅说话硬气，还长得帅，我要是个女的，决逼为他生小孩。[笑cry]
信不信有我 : 我只喜欢那句，别没完没了
艾薇拉_83290 : 男神、帅到我了[doge][doge]
婧岡八陛Lee : 新一代男神
Venus-Ljx : 回复@Palin_Dun:菲律宾是美国的刀，你毁了他的刀，不仅没有了国际舆论的声援，中国还要背上你所说的弱肉强食的骂名！中国不就吃个哑巴亏！
老爷们儿航哥 : 帅！！！！
南京民宗 : 转发微博
伴翔终老i : 我可以说我爱上王毅[色]
泽芝客 : 小日本！我们部长发话了！
Venus-Ljx : 回复@Palin_Dun:要是真这么认为，好好努力让你儿子有个好爸，谁的地位和财富都不是捡来的
Palin_Dun : 回复@Venus-Ljx:只是区别于你爸是谁
老树林 : 国家很争气，就是去给小鬼子送炮弹的中国贱民太多。
非专业考研狗- : 回复@__璐了璐:给你看个更帅的
Sherry琦琦琦 : 这才是真的霸道总裁范儿！！！[爱你]
Palin_Dun : 回复@Venus-Ljx:我至少会毁了他的刀，不至于被人一刀宰了还没反应过来！而不是写封信告诉他，求求你别杀我，你要什么我都给你！
杰杰杰de小杰 : 日本真是有够不要脸的，给脸不要脸
五常之德 : 就算说得天上掉花都没用~小日本生来就➹，挨揍后就听话了
蚂蚁农场千峰 : 日本狗本来就爱插手他国内政
巴衛Pink : 没完没了[doge]
甜茶部落 : 外交部长王毅，新晋全民男神[喵喵]
Venus-Ljx : 回复@Palin_Dun:当然，不读书也行，现今的中国读不读书只要肯干都能生活很好，只不过区别在于一个搬砖，一个监督搬砖而已
有生不散 : 霸气
猴过过 : 说白了，就是，别给脸不要脸。
墨言清狂 : 就喜欢这样强硬的外交手段
你不用记得我的好 : 回复@小嘿嘿闯:周总理是总理我说的是部长
F不是个字母 : 男神好帅啊！
小狮子开心温暖一辈子 : 不要脸的美国和日本！
一根面条_cc : 回复@意大利足球新闻:深以为然
Venus-Ljx : 回复@Palin_Dun:呃.....你要是搁过去就是个左倾，南海实际控制还是在中国手里，其他一切都是浮云！这么跟你说吧，你知道一个人要杀你，有一天晚上你看见他在磨刀，你赶紧拿起石头把他砸死了，你跟法官说他在磨刀要杀我！你看会不会被豁免[微笑]
周豪的豪 : 回复@不可治愈的重度拖延症晚期患者:6666
Palin_Dun : 回复@Venus-Ljx:读书了干嘛？用更华丽的词藻书写和平解决的协议书？
ririlake : 名副其实霸道总裁
喔啦啦FTT : 王毅外长最帅
有个啥比在对我笑 : 告诉你们，这是我男神
抽风少女刘小帅 : 看见没？左手边出门直走右拐坐船回老家，不谢。
麋鹿bbx : 我男神！
About程程程小妹 : 帅
如泪般的你s : [good][good][good]
京北在北京 : 回复@黑和蓝:小叮当
开挂吧yi : 仿佛看到了当年帅气的周总理
D-June : 简言之就是：干你屁事，边儿呆着去。
Palin_Dun : 回复@Venus-Ljx:你把我家的大门都卸了拿走了，我他么还要和你和平协商，是我太窝囊。改天再来一个把我家东西都搬走，我还要给钱谢谢别人帮我搬东西，可好[微笑]
简单XXR : 好酷哦！
想跟我睡的举手 : 很好 这很外交部长
学霸学姐phoebe酱 : 一个人的气质都是靠他的基本素养体现出来的 年轻人还是要多读书[笑哈哈]
小萌lulu : 没完没了，哈哈哈，
阿兹猫大人 : 回复@黑和蓝:因为他嘴角的那两条皱纹就叫木偶纹   - -   人老了基本都会有的
李星呀 : 帅哦
濮水一叶舟zyb : 小日本，你有完没完?再说劳资搞你
12fhgc : [威武]@赵罗丹ZA: 帅爆了！！！
哈姆雷特827 : 日本这孙子是在讨要中国欠它的原子弹啊！王总赶快给倭寇东风快递过去！别让倭寇等着急了！
Una_Ryo : 没完没了还
淡淡的幸福知足派 : 回复@就现在呀:本来就是个混混
Pearl_佩二 : 霸气如你。
Venus-Ljx : 回复@Palin_Dun:说我要多读书，你多读读书吧，高层政治不是我等屁民可以参与的，茶余饭后而已！
上善若水victor : 回复@安逸小妃:哈哈，评论的很到位
平哥2016 : 威武霸气外露
黑花小盆友的把拔是我男神 : 霸气我外长[鼓掌][鼓掌][鼓掌][鼓掌]
Venus-Ljx : 回复@Palin_Dun:你是不是有反华情绪啊？中国已经很明确立场了！可以和平协商，绝不别国干政！这也叫被侵略，菲律宾的渔船不是在所谓的仲裁裁决出来后试图登上黄岩岛？可是结果呢？
阿樽家的猫 : 意思就是 ：我王某人 劝你说人话做人事 别搞事[微笑]
詹小森 : 外长大人威武霸气[威武]
素蓝47061 : 外长大人momoda～[色]
肥嘟嘟小胖子19号 : 王毅：奉劝日方不要一错再错，没完没了！这句话直接说到我们每个中国人的内心心坎里了！
Palin_Dun : 回复@Venus-Ljx:中国一直一副半推半就的态度，早晚被别人划分[闭眼]
手机用户3845386562 : 日本是个披人皮的禽曽，外表做的光鲜，内心肮脏 龌龊。一边手上拿着刀枪，又是鞠躬又是说着对不起，一边毫不犹豫地杀人越货。
CHOC-佳佳 : 不要没完没了的来挠痒痒[怒]
劉Shuai先生 : 我只知道两个外交部长，一个是周恩来，一个是王毅[心]
玩俺疯 : 回复@我就想叫隔壁的老王 的赞:多谢[good]
翻滚吧咸鱼君 : 十年前你们可不是这样评价外交部的[偷笑]
距离死亡最近的伤痛 : 男神！暖男神！
素蓝47061 : 外长[拳头][拳头][拳头][赞][赞][赞][爱你]
燕璃璃 : 强烈建议一大波段子手给部长做后援，怼死他们这些不要脸的[哼]
三姑娘要飞翔 : 威武！霸气！
Palin_Dun : 回复@Venus-Ljx:年轻真好，现在是南海所属权的问题，我们面临的是被侵略！
青柠wuli : 我男神真帅[加油啊]
排排坐吃果果喔 : 这样的男神  才是欧巴
queenyue11 : 帅@我喜欢武林外传2222
我是一颗包治百病的人参果 : 我家几乎两年没开过的电视，为了外交大人，我开始看了，难道这还不算爱？[哈哈]
Venus-Ljx : 回复@Palin_Dun:是，只有菲律宾那样的屌丝小国才会装着一副熊样跟中国叫板！中国是不需要装的！阿基诺可好？
游思无物 : 日本就是跳蚤，不打死它，它就要没完没了
今夕何夕青草离离26673 : 帅死了！
冰冻儿柠檬 : 小日本还没完没了了  给脸不要脸
十九岁的心总有些轻狂 : 这才是真正得中国男神
Palin_Dun : 回复@OwenRommel:不然你以为有多少国家支持？有些东西讲的是质量，数量不一定有用
多动症笨猪 : 日本吃相太难看了
纠结病患者32 : 对，有完没完，美日韩还有那个卖香蕉的
田邳州 : 哈哈，日方需要谨言慎行[强]
好梦Alice : 霸气外长[耶]
想取一个特别一点的名字_ : 你们再啰嗦 我们就要扫黄了[doge][doge][doge]
Palin_Dun : 回复@Venus-Ljx:呵呵呵，一个国家都可以装，我怎么就不能装一次大屌[耶]
Leah-LI-LI- : 奉劝王毅外长开微博[好爱哦][好爱哦]
孙朝宇_Rainy : 毅哥，就是要钢他！嘴臭就怼他！
Cooze-Lin : 干他妈的！[怒][怒]
cewei87 : 理性爱国，此时坚信政府的立场，做好本职工作是我们的国家更加强大，就是最好的爱国，注意不要信谣传谣~
华联Hlwj : 总之，没你的事请你靠边[闭嘴][闭嘴]
刘先生是的好人 : 国家牛逼了说话都有底气，想当年，说这话谁鸟咱们？中华崛起！
柒小念88641 : 日本滚一边去.哪都有你事.
Struggle2016CC : 王部长言词犀利！简单明了[威武][威武]点赞
jiangyafeng2010 : 大国风范！为外长点赞！[ok]
honeybabyTr : 帅
传说中的川页 : 回复@LJ-ZZOO:你这么重视别人的财产，为毛不先把自己的财务公示一下。
青桧鱼泪 : 王毅大大加油！！！
四维12月 : 以前是不是也是这样 只是没有宣传出来啊
跟我学修车 : 选择甲午战败122周年纪念日签署联合声明，意在警告愤青误国，意义深远。亡羊补牢，犹未为晚。
贾圆润 : 评论说喜欢王外长就情欲大过情绪？？[doge]关你屁事喔
花小蘼 : 人民日报发的是新闻，评论里多少饥渴女看不到新闻内容，看到的是一个跟她没有任何关系的发言人？关注点真是够歪，那些叫别人爸爸的，恶不恶心？
干净的鹿 : 好帅
安逸小妃 : 小日本活在火山口不淡定 总是看着中国大好河山眼馋 不关它的事 它也没完没了 甩也甩不掉 莫名其妙
喵小姐MXJDMSH : 霸气！！！！wuli王毅大大！
煎饼打印 : 没错，今天我们都是王毅[doge][doge]对了，麻烦你们关注一下3D打印啊，可以打印煎饼的那种@煎饼打印
xiaoxiao疏 : 王叔叔好帅，长得也很帅！
AtobeKeigoJ : 这一届政府的外交部N B啊[威武][威武][威武]
不猜你是猪 : 日本[日本]政府就一堆屎聚集在一起 组成一大推屎 还确立屎神安倍晋三 隔着海洋与国界我都闻见了腥臭味。
月野二 : 霸气[haha][haha][haha]
白狐越 : 男神
我是郭家大小姐 : 部长说话就是这么直白、霸气！！！[good][good][赞][赞]
砺子皮 : 西门庆！你要是再敢艹金莲，我王大郎就一个月不艹金莲，以示抗议！
Lange_HL : 回复@源氏物語110:你的历史和智商挺让我感人的！吴国发现台湾时，东南亚各国人还没有呢！你说台湾人不是中国人，那你们别用中国字！别说中国话！
haw夏木 : 反了你个小日本了
离索_- : 男版王毅绝对男神[no]️
墨色懂宣悲 : 回复@黑和蓝:你这么一说，还真有点布袋戏的感觉！
ToSticker : 回复@O蜗牛o在奔跑:应该不会，从历任主席职位变化来看，最后要看当没当中央党校主席，王毅部长是外交人才，估计是不会调任。
Venus-Ljx : 回复@Palin_Dun:你哪只眼睛看到我说了冲击两个字？动了美元在亚洲的蛋糕而已，中国作为亚洲乃至世界的外汇大国，强国，却自己拉拢了几十个国家搞了一个亚投行，专搞人民币，这不是动了美元的蛋糕是什么，你告诉我？
柴潇潇胖不多 : [心]
此墨非笔墨 : 说实话，如果这种场合可以骂脏话，我愿意作为中方代表主动出战骂小日本，3个小时不带重样，有一句重样就算我们输。
TaeZisn- : 其实吧，就对于某些只会在这装逼骂中国怎样怎样的，他也就那么回事，自以为自己懂得多着呢，你牛你去找国家说去嘛，你牛你带兵去打那些国家嘛，恩，对于这种人，也只有做汉奸的本事了[哈哈]
诺贝尔奖待定者 : 我国已基本摸清世界的底牌[阴险][阴险][阴险]
快捷奏美食 : 小日本，滚一边去
SPECIGiii : 王蜀黍:  一天不误正业，在外面瞎来抢南海！[怒骂][怒骂]乖～[害羞][亲亲]还是安心搞AV  干好自己的本职工作才是发家致富的不二王道[doge][doge]
wz韦真 : 好帅
OwenRommel : 回复@Palin_Dun:我当然很清楚我自己的国家怎么样，她在国家主权上绝不像某些人那样跪在地上起不来，她的生活不算最好但在不断进步，反倒是某些外国新闻颠倒是非，竟说出南海仲裁仅六国支持中国立场的鬼话[微笑]
稷丞 : 若嘴炮堪以大用，区区不才愿与倭人一争高下[偷笑]
无药品 : 我们要团结一心，坚决反对这种没有任何意义的仲裁，坚决维护国家的主权不动 摇.
Venus-Ljx : 回复@Palin_Dun:敢问阁下什么学历？别自己一身shi说别人没擦屁股，都是万草从中一根针，装什么大diao
sirsnow : 回复@子虚乌有的铭:像你这么没脑子的人看多少书也没用了。
今日阴转阵雨 : 没完没了了[doge]
smile莲莲爱庚 : 用日语biu他们。
Venus-Ljx : 回复@Palin_Dun:世界地位，肯定动不了他的，难道中国不让美元吸血的能力都会没有？多读书的应该是你，人民币在亚洲的地位与日俱增，这些是你不可以忽视的，当年日本与中国想要在亚洲做空美元的时候就一个钓鱼岛，把中日合作送上断头台！这些始作俑者都是美国
用户34857 : 热评里说让王部长公示下财产那位，你是不是智障？作为一个日本人，你中文说的那么好也是棒棒的
我心向你丨 : 外交部长长得一副爱国脸[害羞]
毡稳蚊 : 男神[爱你]
weisw1 : 回复@weisw1:日鬼严重威胁亚洲和平！
孤狼A组海狼 : 可以做好几组外长的表情包
小灬情灬绪 : 小日本个无赖。
刘MT的黑眼圈 : 我单方面表示这是我干爸比[微笑]
一朝结局定义整个你 : 中国就该有一个像王毅这样的人
Palin_Dun : 回复@Venus-Ljx:可笑，美元一百多年的地位，人民币能撼动，冲击？拜托，多读书谢谢！
清枫亭立 : [good]外长
weisw1 : 呵呵！对疯狗！无良无赖无德之鬼！谈神马法与理？！
北堂深巷 : 听到没，我王毅大大让你们闭嘴
晨曦hg : 好霸气[给力][给力][给力][给力][给力]
姜武品牌运营总监毛委员长 : 不服？办你！
已经突破微胖界的孙磊 : 这家伙，你们看得出来有63岁吗？？？[泪][爱你]
-唐星星 : [鼓掌][鼓掌]
Venus-Ljx : 回复@Palin_Dun:中国的一带一路，亚投行这些都是在与美元抢占市场！凭什么美国凭借美元可以不费吹灰之力掠夺世界财富？正是因为中国的这些举动动了美元的蛋糕，现在才有层出不穷的麻烦，并不是中国怕，而是中国不屑，如果真的为这一点事情鼓动战争，才是真的正中敌人下怀，战土永远不会到美国，而美国可以坐发战争财
Palin_Dun : 回复@Venus-Ljx:经济？？回去看看经济这个概念，再来发表意见谢谢！
强者恒强_33512 : 菲求中方出资发展经济，美乐此不疲跑来中国秀哥俩好，日急啊。
龙吟万象 : 要不怎么说“小”日本呢。
阿紫夫人 : 男神说什么都对～
我们许过的愿听的歌游的河_ : 回复@dramas_:帅！
正版某小莹 : 太有范儿了！
Lan_sam : 有一种怒斥前人纠缠的感觉
回不去的过去201612 : 霸气王爷爷
Palin_Dun : 回复@用户5304328915:你妈真大
宝宝Boa- : [害羞]王霸霸帅炸了
童大大大童 : 回复@我是毛毛耶:[哈哈][哈哈][爱你]
Venus-Ljx : 回复@Palin_Dun:首先中国是社会主义，你说的弱肉强食在商场，在战场确实是这样，但站在中国社会宏观立场，这种规则适用性极小，如果中国是一个资本主义国家，绝对没有青藏铁路及公路等等大规模资金扶贫，与其用战争来换的一时爽快却要用两败俱伤来作为代价，不如在经济金融上努力角逐！
wyx哈喽哈 : 好帅！！！
MEU-chen : 狗日本，关你们屁事，轮不到你们BB，
我是毛毛耶 : @童大大大童 一错再错 没完没了[眼泪] 跟骂儿子似的
C_ccC_cC_ : 又帅又有才又霸气…帅的你无所不能[色]
用户5304328915 : 回复@Palin_Dun:快闭嘴吧 ，污染评论区，烦死了，沙雕
Mvintage : 回复@游悠自在:可以把您派去评定日本？小市民思维就不要试图去理解国家大事了
回不去的过去201612 : 我们的外交部部长好霸气好有范，好为我们中国人争光。
墨玉可爱多 : 越来越喜欢你了，这才是我们中国的男神啊，我要是早生三十年一定嫁你。
Mvintage : 中国最大的敌人不是美日 也不是俄罗斯！而是国内的汉奸公知美分文痞流氓讼棍！
鸣樱V : 日本政府别残害你的子民了，讲真
Carzy丶沙 : 太帅，差点都要弯了
见光死汉子 : 回复@青春短句:赞你妈？
仓央嘉糯 : 外交部长这么霸气！虐他小日本！
游悠自在 : 就只能是这样了
MEU-chen : 给部长点赞小日本不要脸，关你们屁事，不是你的手，轮不到你们说话，钓鱼岛也是中国的！
彩613 : 男神给力
懿紓 : 能动手就尽量别吵吵，累不累！
Palin_Dun : 回复@JunGloria:上行下效，我嘴炮，我骄傲！🤔
云海春松 : 日本就是美国的一条狗，唐朝把他打怕了他就法唐。明朝把他揍了五百年安定了。我们现在要发展好自己的工业摆脱用它的汽车相机，去揍他
楚哥哥哥哥哥哥 : 中国旁边的一个小县城有什么资格总是叽叽歪歪，小心雄鸡把你咬了
孤单就是手机里全是风景照 : 回复@Palin_Dun:跪多了起不来
Palin_Dun : 回复@闲豆脑儿绿豆沙:政治智慧？？呵呵呵，难怪贪污腐败这么多年才查出来，这个智慧厉害了！
天蝎小陶 : 新晋男神有没有，有没有·········
old-yeah : @MD-Dragon
崔阿倩icon : 日本请你不要干涉我们的内政，我看我们不能愉快的玩耍了。[拜拜]
Vulpes_zerda : 回复@向沐宸:[生病][生病][生病][生病][生病][生病][生病][生病]
索菲亚的冰天雪地 : 回复@春风亲吻我像蛋蛋蛋蛋挞_:我已经不想跟他说话了[眼泪]，
JunGloria : 回复@Palin_Dun:就问你一句说这话你知道你自己是哪国人吗 你知道你自己现在在哪国吗 你知道你现在踩在中国的土地上 开战了你知道中国的百姓面临什么吗 我看你才是会打嘴炮的人吧 你行你上啊!
Palin_Dun : 回复@OwenRommel:呵呵呵，自己国家什么样，自己最清楚，不是一篇新闻可以决定的，看看你身边周遭的人，你会明白有一种新闻叫国内新闻！
-王王王王王煜 : 我爱他！
她叫王大傻 : 666
依大王- : 在吵掀翻你的黄碟摊 [doge]
闲豆脑儿绿豆沙 : 回复@Palin_Dun:能站在国际的舞台上被你认识的官员一定是有政治智慧的，比起p民考虑得不知道多多少倍[拜拜]
井优食 : 我们国家永远不要相信日本和美国
挚爱澜西 : 回复@Palin_Dun:人云亦云
小荣嘻哈 : 打死那个龟孙。。。
蜜似糖suga : 我觉得不是奉劝，更像是警告啊喂[嘻嘻]
Palin_Dun : 回复@挚爱澜西:不知所云
再不是猫咪 : 不好意思了，涉及到我国的主权问题，你们再荒谬也是零容忍咯。
小萝莉sweet : 有意思@小陈在天: 又是这个手势
Palin_Dun : 回复@索菲亚的冰天雪地:这支铅笔是我的，你要抢，我就要因为你比我高大威猛，就把整个铅笔盒都让你拿走么
努力补眠的緋小音 : 该霸气时就要霸气[哆啦A梦花心]
细路祥要加油 : 我就想'知道岸田怎么回的
魏晨的御用婚礼策划师秋秋 : 给男神点了个赞[心]
韦丫么薇小宝 : 坚决捍卫我国主权
XIH___ : 日本请自重。
OwenRommel : 回复@Palin_Dun:哈哈哈哈又是这种国内新闻不信看个国外新闻就优越感爆棚的人[哈哈]反正只要是中国人自己说的就是假的编的，外国人的新闻就是完美正确[微笑]
夏了不夏天 : 回复@檬步步:对于流氓无赖就得这样～～    评论里的单方面宣布是我爸  笑shi我了
挚爱澜西 : 回复@Palin_Dun:愿意当弱者谁管你了！就是点名在骂你。都会有一堆人点赞。你信吗？
荷柏园护肤玲玲去斑去痘 : 支持中国领土完整无缺，日 本都不想想自己；就知道挑衅别国，你那么厉害和美国过过招啊；活该现在原油快消耗殆尽[坏笑]想想自己的后路吧……
SHUO_江素 : 评论里还给日本话语权，日本脸都不要了要什么话语权[微笑]你这么替日本说话你立场有问题啊[doge]
时光写下的沉默 : 南海事件让我认识了这个霸气侧漏的外交部部长 关于他的每一句话都简直帅呆了
J_COCOA_J : 下次播新闻的时候把外交部长王毅改为霸道总裁王毅。
张立张立张立 : 帅的一比~~
J_COCOA_J : 霸道总裁王毅。
Palin_Dun : 回复@索菲亚的冰天雪地:呵呵呵，首先，没人想打仗。我只想说，当你或者你的孩子在学校被欺负的时候，不是任人欺辱就可以了事的。别人航母都到家门口了，还在视而不见听而不闻，站在泉水开嘴炮！还有你说发展，发展所需的资源，从来都是弱肉强食的分配规则。
三横一竖是我姓 : [bm吐舌头]@划舟不靠桨: 感觉还有“滚蛋”俩字没说出来
AnimoPercettivo : 外长说话就是这么直白不官方
春风亲吻我像蛋蛋蛋蛋挞_ : 回复@索菲亚的冰天雪地:这种人就在那刷存在感  不用搭理 无语了
萧晚半夏 : 王毅外长帅呆了，霸气[good]
vsaew : 男神好帅
wsjudie : 太帅
灬Helen灬 : 小日本 现在生活过得好好的 就别来招惹强大的中国  小心抢着火了  你们好日子就没法过了。
一上课就犯困m : 你这样，会撩到我们的
小鱼仔Yuri : [doge]没完没了
Paradiselost5218 : 外交部再不强硬，民众就真的要群情激愤了。现在的外交手段确实得民心。
索菲亚的冰天雪地 : 回复@Palin_Dun:我没懂得意思，我只想表明中国领导人肯定考虑长远，开战对中国并没有好处，最多只是逞一时之快，相反，没有认清国情，只想盲目开战的不是你想表明的意思么？
我是乖米妮 : 政府官方声明越来越口语话，这种未被刻意梳理过的表述只有十足的底气才会有的自信吧
摩羯贰月 : 小日本就是欠揍
Luck丶光 : 美国和日本待遇反差太大。。。
晒太阳晒出了黑眼圈 : 日本孩子特别不听话
米斯特-V : 回复@LJ-ZZOO:神TM愤青
索菲亚的冰天雪地 : 回复@更好_22310:很赞同你的说法
别放大招G : 回复@Palin_Dun:哇哦。头像作呕
安丶忍 : 帅呆了！
ufo1231118 : 回复@神一样的鲨鱼08376:有共青团，有周小平………我就不操这个心了………我去搬砖喽…………[喵喵]
Palin_Dun : 回复@OwenRommel:那是国内新闻，谢谢[眼泪]
戴着大眼镜的大海燕 : 男神，帅
Binbining : 转发微博
forver欢宝 : 王大大加油[左上](^ω^)[右上]，支持你
立立二胖 : 这个男人好帅
xca888 : 公对公玩硬的，没有任何问题。如果对记者说来硬的，就不对咯
索菲亚的冰天雪地 : 回复@Palin_Dun:盲目开战就是莽夫之举，现在中国发展需要和平的环境，和平与发展是世界潮流的走向，如果事先挑起争端，就会坐落违背和平与发展的原则的口实，岂不仇者快！中国不会蠢到如此，国家是大家，岂能用小家方法解决，你若那么想开战，何不去参军，在这挑起事端没意思
更好_22310 : 整天嚷嚷着赶紧开战，真开战了我看不见得你会去前线吧        国家考虑事情比你长远！！不要一天来这秀智商只知道喷！
南阳虹信 : 老王真帅
小白白LINO : 我们中国人的偶像
OwenRommel : 回复@Palin_Dun:待宰的羔羊[微笑]这是我听过最好笑的笑话，他们不服来宰啊，可惜前几天日本空自还被吓得丢干扰弹逃跑
难解风情y- : 别给脸不要脸[微笑]
萌萌哒这是属性不叫病 : 简称:关你屁事，回家玩儿蛋去[doge]
飞舞的小角辫 : 点赞
honey我信了你的邪 : [威武][兔子]@荞荞又不胖：看见祖国这么直白我也就放心了[喵喵]
陶瓷兔子爱上了小女孩 : 给你个白眼自己体会。
陆倪筱 : 日本当局 请自重
Palin_Dun : 回复@索菲亚的冰天雪地:看不见自己的缺点，盲目自大，死的早。现在不是涨威风的时候，真干仗的时候，全国人民一起吹，就能灭了美国？？
山慕蝉 : 回复@LJ-ZZOO:比你多，不用
如果狐狸不记得 : 他内心对表是。你们这帮臭不要脸地。
谁允许你直视本少年 : 面首现在这么火
王再群 : 回复@Palin_Dun:呃呃(°_°)…
索菲亚的冰天雪地 : 回复@春风亲吻我像蛋蛋蛋蛋挞_:就受不了这样的人，一副唯恐天下的架势，在母国的庇护下生存，不尊重他人
OwenRommel : 回复@Palin_Dun:身为外交部长做好了外交该尽的职责，表明了中国的立场态度为什么不能赞赏？
柬埔寨李美航 : 我大哥已经发话了，让我带着999999999兄弟做好踏平日本的准备。
和锋工作室 : 评论热门的都是我的孩子[喵喵]
Palin_Dun : 回复@王再群:对啊，上行下效，我嘴炮，我骄傲[坏笑]
索菲亚的冰天雪地 : 回复@Palin_Dun:我发现你这人是怎么了，有没有一点民族自豪感，长他人志气，灭自己威风有意思么！
陈燕燕yyy : 别没完没了 简单翻译。到最后 你会没的玩 你也会没了[偷笑]
索菲亚的冰天雪地 : 回复@So丶尐緢168:目光短浅，莽夫之举才是开战，
玉罗西 : 回复@春风亲吻我像蛋蛋蛋蛋挞_:他妈是日本人日的，你看他那狗样，
王再群 : 回复@Palin_Dun:真搞不懂你怎么想的，说的就跟你这些话不是嘴炮一样→_→
酱紫i998 : 霸气，[强][强]
落空灬殤之觞 : 霸气
索菲亚的冰天雪地 : 帅呆了！
_張bobo : 有视频不[馋嘴]
若你能感同身受 : 男神
halowinter : 好帅啊！
Palin_Dun : 回复@王再群:嘴炮打的再响，也改变不了我们是待宰的羔羊的命运！可以这样理解你的意思么
山口家的丹丹君 : 帅就一个字，我只说一次！[doge]
AO帕波 : 王大大能这么硬气说明中国国力比以前好多了[心][心]
荷兰琉璃月 : 挺王毅部长！[爱你]
Palin_Dun : 回复@OwenRommel:那有什么好舔的？看着觉得恶心，
猫恰灰-破茶杯 : And then? No then...
王再群 : 回复@Palin_Dun:你这是什么思想[眼泪][眼泪][眼泪]美帝就等着咱们先动武………
李飞-sir : 打
爱你你千万遍 : 简称，就是不要在那里逼逼
好好先生丶风华正茂 : 周总理，曾经说过，我国不放第一枪的，
郑习习JIE : 霸气侧漏[愛你]
小嘿嘿闯 : 回复@你不用记得我的好:周总理才是最帅的外交部长
OwenRommel : 回复@Palin_Dun:外交部的作用就是这样，打仗是军队的事，印度，越南，苏联，联合国军，解放军打得仗还少吗，不都是先外交后军队的套路？
Someone_1970 : 回复@孙喵喵还是孙猫猫:说的好
当水星遇见流星 : 小日本就是喜欢戳事，欠削。中国就该这样霸气
So丶尐緢168 : 经常看到有人说，打嘴炮有用？赶紧开战..！想说这些人什么心态，目光短浅！
Palin_Dun : 回复@春风亲吻我像蛋蛋蛋蛋挞_:这叫强势？我看出来的是委曲求全，软弱无能，然后还搞水军跪舔！哼
老家小吃店 : 打倒日本鬼子！
可爱super小璐 : 说滴好[good]
春风亲吻我像蛋蛋蛋蛋挞_ : 回复@Palin_Dun:真是搞笑   外交强势你也喷[微笑]
Palin_Dun : 回复@挚爱澜西:我就是搞不懂，舔什么，有什么屌意思，这是他的职责，位高权重。
汉塔蛋堡 : 门外那边，请你出去
墨如诗人 : 中国人不是不会动武 只是不想动武，爱和平。
春风亲吻我像蛋蛋蛋蛋挞_ : 萌王毅萌王毅 [好爱哦]外长威武[心]
三岔河口张退敌 : 白眼男神🙄️[爱你]
love_my_ba0 : 回复@我只是一只僵尸粉嘤嘤:哈哈哈，你再这么跳我就一巴掌呼死你
Palin_Dun : 回复@王再群:那全国一起打嘴炮，世界都是中国的
外面的世界y_ : @若你能感同身受 男神
Palin_Dun : 回复@龙舞烟水天:不敢打就学清政府，洗牌
陌上MO : 日方怎么回答的？
挚爱澜西 : 回复@Palin_Dun:你怎么不去当兵。不去打仗。他作为一个外交部长做的够多了。你做了什么。你不是在中国的保护下生长。永远不知足。永远只会杞人忧天。我作为了一名中国人感到不逼的骄傲。
王再群 : 回复@Palin_Dun:没你想的那么简单，如果打起来，某些国就真有理由来参与了，，，，到时候受罪的还是手无寸铁的老百姓。。。。
子虚乌有的铭 : 回复@小文盲dyq:回去查查地图再回来说话
子虚乌有的铭 : 回复@sirsnow:唉，被忽悠的可怜啊.自己多看书。
木耳朵oo : 男神，我爱你[爱你][爱你][爱你]
荒原东耳 : 总有人想打仗……真是不是你在战场你就站着说话不腰疼，真当什么事情都可以一炮轰了这么简单？？？什么脑子……唯恐天下不乱的德性……
两个月亮c : 这才是国民男神
拯救Able : 门在那边，卖AV的出去[doge][doge][doge]
Mr_z_show : 不要一错再错，没完没了。 男神霸气侧漏啊[喵喵]
龙舞烟水天 : 回复@Palin_Dun:军队从来都是最后的手段，功夫在平时。用军队，经济做后盾，用外交挤压。你看看孙子兵法就知道，兵圣也不是一上来就喊打喊杀，在动兵之前还是用谋，交等手段来达到目的。
贼眼睛绿豆 : 好帅，好像嫁给他
Tu子要吃胡萝卜 : 说得好！外交部现在越来越强硬了！王毅外长不愧是我们全民偶像！[嘻嘻]
加菲_加油 : 为了提高整个句子的分量，最后应该再加一句否则......
徐小姐SOO : 好帅啊部长大人
Destinyllllllll : 回复@Berry-be:[偷笑][偷笑][偷笑]
哈拿是条老母狗 : 他妈的永远都是奉劝警告抗议
大道理会讲不会干 : 回复@小琦的兔子:他们心里有鬼自然不敢面对正义的眼神啦。
Life_is_but_an_empty_dream : 王毅觉得怎么就和有些傻子说不清了呢，说了非是不听呢
小琦的兔子 : 为什么王毅外交部长总是这副眼神？不解！这样会给别国家的领导人一种恐惧感！[惊讶][惊讶]#南海局势# #外交部长王毅# 
AAA小虾米 : 硬气！帅气！
不瘦下来艰苦不改名 : 配图优秀极了
低碳George : 小日本一直有称霸之心
_Since1993 : 你劝他听？
王泡泡1信1翊 : 男神王毅，男神男神
爱熙姐爱伟哥 : 小日本就是个搅屎棍
王振XDL : 日本就是老美的走狗！！！真是欠削！！！
兰海68925 : 小日本，终会有一天你会死
WANGZC_JADE : 沒有完了[doge]
何以丨青春 : [good]
斐与众不同 : 就不应该见小日本，让他们意淫去吧
---南方菇凉--- : 帅我一脸
Palin_Dun : 醉了，是中国人真的没有血性了，还是么逼回事，说个狠话这群智障就开始舔了！中国有句老话，光说不练假把式，不要打嘴炮，打嘴炮有用，还要军队干嘛呢！天真加弱智！
你被全球通缉了 : 艾玛，帅炸了[爱你][爱你]
道格拉斯青格尔 : 男神帅帅哒，加油
心大量宽的人 : 有十四亿人民做后盾，中国谁也不惧，给王毅部长点赞。
巧笑倩美目盼素以为绚 : [笑哈哈]@淡淡清香扑鼻来: 
Berry-be : 回复@Destinyllllllll:还好我爸不玩微博[doge]
夕阳-摩天轮 : 还是不要打仗
涅风格 : 要不要这么帅。。
我叫波克比_ : 妈呀，有没有我毅的日程表，想追[doge]
nicaicai00 : 回复@XLWB就是屎一坨:看来你脑子是屎做的
心小彤 : 我是外长的迷妹！
meseems-x : 要我说就是臭不要脸
在那尘埃 : 横眉冷对[哼]，大写的帅
小冰糕-ice : 新晋男神   部长大人威武
vickHA : 就打嘴仗牛逼，钓鱼岛至今还在小日本实际控制下
azure庚元dido : 卖av的别多管闲事[笑cry][笑cry][笑cry][笑cry][笑cry][笑cry][笑cry][笑cry][笑cry]
长呆毛的小公主 : 一生气把你小日本也收了，起名叫AV拍摄总基地
学霸模式正在开启中请稍等 : 回复@麋鹿gained:[眼泪] [眼泪] 说错了说错了，简化字哈哈哈
丁凡同学 : 回复@长安街拓海:你懂个球
Mitchie燕云 : 我想知道日方的回复[微笑]，毕竟太直白！
HelloKitty家的小涵 : 帅气部长[爱你]
LinziKing : 回复@O蜗牛o在奔跑:不可能的 现在64了 一般干一届人大 政协副手 解决下副国级
一棵被思念的树 : 这个老头好帅[哈哈]
长呆毛的小公主 : 回复@黑和蓝:哈哈哈，只是法令纹重了点而已，不过你这么一说更萌了
拂柳若素依 : 男神的一句奉劝你一句应该就是，别得瑟了，我要生气了。日本做的事确实恶心
Destinyllllllll : 回复@Berry-be:.........你爸看到会气死
MMM-JJ-Y : 心疼文科生
_Meuuuu : 不要没完没了[微笑]
莲心悦怡 : 痛快！
死贫道不如死道友55555 : 就是帅
站着说话腰不疼啊 : 他可比那些帅气的哦吧帅一万倍
给你AD钙奶 : 外长说的全对[哈哈]表白[拜拜][拜拜][拜拜]
看清日本真面目 : 日本还是多担心担心自己的东北核辐射吧
白马跃长安 : 对日外交就要主动出击，不能被动应付。
长安街拓海 : 除了强调，声明，奉劝，谴责还有什么词。换我我也会奉劝，而且还要谴责
Crazy丶bloom : 现在中国我最服你
haiyan5987762216 : 说得精辟，给小日本点颜色！
echoringan : 主要日本听不进去，不要奉劝了，直接经济上制裁他们。
你这里没有故事也没有酒 : 日本真是神烦，也就秋田犬还招人喜欢。
c长大我就嫁给你x : 回复@LJ-ZZOO:有病
EverNaiq : 说得好，不能让小日本鬼子再猖狂！！[怒骂][怒骂][怒][怒]
啪啪夜话吧 : 王毅大大的意思就是：小日本尼玛的少装比~南海关你毛事~你丫的再不老实，踹死你个膏药国~~~[doge][doge][doge][doge][doge]
hljsfh : 日本是真怕中国控制南海后收他们的过路费，而且不开心时，给钱也不让他们过！[挖鼻]
橘子没扒皮 : 回复@LJ-ZZOO:期待！！！
四喜是一个洋气的名字 : 日本又从其他国家买了许多新型武器打着实验的名号实际在壮大国防武力[拜拜]新型武器特点：轻便且攻击力强，你说他们还不是别有所图？[喵喵]防人之心不可无
ljs_VolJin : 回复@梧桐叶落吾三生:它懂 可是跟这种国家 不适合文明的交流 该出手时就出手
翻车鱼23333 : 没完没了，烦死了[doge]
灰色Echo : 回复@SSSSSong_:真爱[爱你]
浆糊桶淘江湖 : 转发微博
高高云混 : 回复@熊孩纸是我的熊孩纸:在没完没了就打它 暴打它
诸葛平远 : 与虎谋皮
天魔星这个名字有人用了 : 灭了得了
O蜗牛o在奔跑 : 回复@ToSticker:你们说、  有没有可能。过10年以后、 他当主席呢
楊凱kaikai : 王之蔑视
迷迷糊糊的咕噜 : 简洁粗俗点就是跟日本说关你屁事，咸吃萝卜淡操心
御芷兰 : 简直没有更帅[心]
非著名小黑粉 : 中国已经不是当年的那个国家了，关于主权问题我们寸步不让[威武]
眼泪的女王 : 回复@LJ-ZZOO:这么费劲心力挖苦中国人，你过得也是够苦的[微笑][微笑][微笑]熏疼你[拜拜][拜拜]
天生偏执狂BOO : 感觉像是在打发用怀孕留住男人的小三
爱稳稳的 : 小日本要是能听劝告，就不是小日本鬼子了
杨蓉这名字是我的 : 日本没事就tmjb爱凑热闹，烦不烦。想赢的别国尊重你们，先自爱吧。
苏小小小小巫女 : 王外长就是那么帅
bleufay : 男神啊啊啊啊啊啊啊啊啊霸气！
小聪花想改名叫什么呢 : 可以，这很强势
__我改名字了你还会找我吗 : 男神差个微博[羞嗒嗒][羞嗒嗒]
艾玛少女 : 卖芒果的现在只想求中国爸爸给口饭吃了，日本还在唧唧歪歪，插嘴的稿子写好久了，结果卖芒果的突然就坚持不住了[眼泪][眼泪][眼泪][眼泪]
做一个安静的疯子yc : 真帅
Lius-T : 最近王的脸出现次数好高
Life-_W : 这个霸气劲儿，想想都觉得帅呆了！！！[噢耶]
粉圆不是嘎嘎 : 部长[威武]
阿柒就是虫小爷 : 我男神[喵喵]
国画热 : [斜眼]这个表情让我一看就能想到王毅部长[飞吻]
我就是键盘侠啊 : 日本人素质都这么差吗？对待残疾人那么残忍算什么本事。有本事你去找正常人啊。
Siciri : 没完没了
1987年11月06日 : 回复@Lawyer蔡:钓鱼岛邓爷爷的年代都共同开发，留给后人。你干嘛总是一根筋呢？[doge]
让我注册成功吧God : 配图说明：请滚
就现在呀 : 像老师教育混混
隋莉莉 : 回复@LJ-ZZOO:羡慕嫉妒恨
1987年11月06日 : 回复@LJ-ZZOO:你是日本派来的吗？
我的晕晕 : [doge][doge][doge]卖av的不要想着我的鱼好吗？
快乐快乐这才叫意义 : 魄力，这才是男神[笑cry][doge]
wang晚秋 : 迷死了
summer_陆静夏 : 霸气
杭州无痕接发造型师 : 符合在浙江省杭州市江干区九年义务教育公办小学条件的外来务工人员，为何迟迟没有江干区教育局的通知、社保，劳动合同，暂住证，租房合同，结婚证，独生子女证都齐全，杭州市教育部门为何没有任何明确的答复、证件齐全符合在杭读书的没有给安排，而证件不齐全的小朋友却收到小学录取通知书，天理何在？
飞菲5899454111 : [笑哈哈][笑哈哈][噢耶][噢耶][噢耶][噢耶]帅
仙er-B_ : 太霸气了
孤独患者rrrrrrr : 这很王毅[doge]
月光照在清河上 : 日本狗最近国内经济一团糟，全靠跟中国搏出位维持执政，悲哀！
学生K同学 : 回复@LJ-ZZOO:什么都喷 有意思麽
MengJun_Yu : 部长威武
圆滚滚d土豆君 : 回复@云爱雨_:恩，我是说实在不行的话。
上弦月_菠萝派 : 中国:你们谁跟我叫板的有种往前走一步看看？！然后美国，菲律宾等等所有人都默默往后退了一步，日本发现自己成了最前面那一个。。。[笑cry]
windtalker-xu : 拆那国没完没了的转移国内矛盾
问君何人 : 日本人做事从来不顾后果。别急，日本过不了几年就会来拜求中国的。
花猫舅老爷 : 妈的卖房卖地打他丫的
岑双荣 : 回复@吳嘉嘉呱呱:晚安
阳光下1117 : 666
撩神占公子 : 没完没了
明月广子 : 该考虑收复日本了，然后又多了一省，日本省东京市
笨熊198701 : 没完没了……[笑cry][笑cry][笑cry]
大大的锋哥哥 : 我tm真喜欢最后四个字，没完没了
鸡腿妹砸 : 真的很感谢这些外交官[可怜][可怜][可怜][可怜]
孟彦弘 : “一错再错”，还是个话。“没完没了”，是啥话呢？[疑问]
_米立恩先森 : 霸气[good]祖国需要这样的官员
翟骏 : 我大中国威武，所以赶紧来开户炒期货吧。
小瓶盖owo : 不要一错再错没完没了[微笑]
乐活levol : 谨言慎行一错再错这俩成语估计日本代表听不懂吧[doge]
dhfyshidnssu : @大款玉 @番薯培子 @大象鸡腿饭
Lawyer蔡 : 说了这么多年，钓鱼岛回来了吗？
梦幻星座小马甲 : 王毅外交部长，要是娥某一天变成同性恋，都是你引起的，你就不能安安静静地做个帅气的外交部长？为什么还要那么霸气还偶尔萌一萌？这样真的好么？
果子的小姨went : 回复@LJ-ZZOO:行了 别酸了 怎么什么人都有
那些年那些事那些时光 : 部长大人，威武[好爱哦][好爱哦]
6xyUuU : 不仅长了个帅样做事也好帅！！
William的女票 : 男神
798小斌 : 中国是时候该讨论琉球的归属问题了！
胡双丽_ : 男神[哆啦A梦花心]
李昕-第八滴眼泪 : 男神，骂他们！
我是祖国的小花朵朵朵朵 : 一种霸道总裁范儿的气息，扑面而来
_LIUSS : 霸气男神
云析月兮 : 就是就是
德惠将军 : 外长风度翩翩，讲话有理有据[赞啊]
唯康lemon : 看到那句不要没完没了，笑了
小清新曼 : 不行就闹它小[日本][哈哈][哈哈]
梦幻星座小马甲 : 帅气+霸气+萌呆的完美组合
花月轩传奇 : 昔日的列强欺负中国惯了，所以听了中国如今强硬的回击有些不适应了，适应就好了。
Jeen__ : 中国大多人民意愿：一个字，不服就“干”
Ms晗Ms : 帅的不要不要的呢[好喜欢][好喜欢][好喜欢]
倔强的向日葵啦啦啦 : 小虫子[毛毛虫]，我们有杀虫剂[怒][怒][怒]
小呆子喜欢陈二爷 : 就该好好治治那些个傻x国家。
梦幻星座小马甲 : 中国帅官，我只认周总理和男神王毅外交部长
学无涯辛军 : 显然中方的态度转向明确而强硬了，这是国策的转向，不像之前某国什么的了
小希39552 : 长的一脸正气
葡萄601 : 男神  好帅！
飞雪映春到 : 中国已经牛了
夕瑶舒夏An : 安倍[狗]你家后院死人了你不知道啊？还有空来管我们内政。
佳妮精工织补坊 : 日本忘我之心不死，冲出重围之时，掘起之日，不要忘了“日本礁国”，必须重点照顾！
老鼠跌进了米缸里 : 主要是采取措施，否则[doge]日的总以为你能奈我如何。
小啊曾_姐姐 : 国民男神[求关注]
好时每刻123 : 我平时偶尔吐槽点自己家的事，那是因为是自己的国家，希望变得更好，但一致对外我绝不退缩，有国才有家。
vivian肖安安 : 帅气的外长大人，真男神！
用户5527518600 : 那就打呗。BB毛啊
吉柯溪卿 : [鼓掌]
南南北北1225 : 回复@黑和蓝:我觉得你的嘴巴像猪屁股。
Julia1314521 : 小日本，嘚瑟
1316漫漫长路 : 主要中方也没有这个迫力？[挖鼻]
哦也1798 : 日本你们不作死就不会死！小心一点，不然连你们一起打！[笑cry][笑cry][笑cry][笑cry]
麋鹿gained : 回复@学霸模式正在开启中请稍等:嗯？我一直打的就是简体字啊
继科的真爱粉 : 帅呆了
横园竖梦 : 看看我不屑的眼神！[白眼]
铭宝-olivia : 男神男神
懒羊羊静水流深 : 别跟狗皮膏药似的！[笑cry]
OKPASS : 回复@手机用户0000725:发生了什么？
HYQ小小y : 该死的小鬼子，日本鬼子该死
冬季丶草莓 : 这个城管也应该奉劝奉劝了
好时每刻123 : 别没完没了，不爱搭理你[喵喵]
浅笑依然1234 : 讲话简单明了，言外之意，别给脸不要脸。
我叫喷子biubiu : 回复@子虚乌有的铭:脑子是个好东西
废柴寻寻 : 迷妹一号前来报道
骑猪去兜风的海角 : 没完没了，无理取闹，屡教不改
我要一生陪伴黄轩 : 日本就是一条疯狗，除了勒死它别无他法
小文盲dyq : 回复@子虚乌有的铭:俄国侵华是在沙皇俄国，那时候还是封建王朝呢，共产党宣言才写完，俄国还没有变成苏俄，俄国也还没出现共产党好吗
我叫喷子biubiu : 没完没了[doge]
放轻松1975 : 我想知道日本的媒体对此有何报道？
Q倩仔倩仔倩仔 : 对他实力圈粉[哈哈][哈哈][哈哈][哈哈]
陌上花开-可缓缓矣 : 帅！
景天v : 回复@苏州会粹:咋回事？
sirsnow : 回复@子虚乌有的铭:你历史谁教的？俄国侵吞中国土地的时候共产党还没诞生呢哪来的党媒？
燕飞Wang : 王毅伯伯威武，给您点赞[good][good][威武][威武]
闲酒舒 : 新款表情包出炉
老李一缺三 : 王毅（严肃脸）：卖碟子的，你可以了哈，差不多就行了
fuunosemi : 日本鬼子，干什么都要插一脚，嘴脸暴露无遗
宁泽涛和王晶 : 外交部部长最帅，最英勇[哈哈]
茉莉薇锋 : 日本怎么这么不要脸？滚远点不行吗[怒][怒][怒]
該-用戸卜侟zai : 是我们的别人始终得不到
神一样的鲨鱼08376 : 回复@ufo1231118:来，美国也来，到时咱一起去杭州抗议去啊，最好能把安倍和奥巴马拖出来打。反美反日喊了那么久，终于自己送上门了，可不能放过那么好的机会
張起灵12702 : 自带霸气的王部长
子虚乌有的铭 : 你们咋不说俄罗斯吞中国那么多领土的时候，媒体姓党就是成了党的武器，忽悠百姓。请你们站在事实角度去做一个媒体人。曝光不是宣传家丑，而是让我们民众有机会知道错误，让行政者知道不犯同样的错误，正因为我们爱自己的国家才更在乎他的强大。至于爱党就看他们自己的行径了
裴璐vvvvvvvvvv : 大大:打它
醉呓狼 : 看到“没完没了”莫名想笑[笑cry]
伏增波 : 滚jb蛋 把门给我带上
qian钱希希希 : 霸气
鹿fi : 王毅 好帅[爱你]
大个儿文学家 : 以战止战，只有能也敢把它灭门他才会尊重我们 @人民日报:【人民微评：对话远胜对抗】选择对话而不是对抗，维护和平而不是制造分裂，中国东盟联合声明不提南海仲裁，传递出积极信号。那些选边站队的国家没有得逞，那些别有所图的国家该靠边站了。中国东盟本是命运共同体，即便有分歧，也完全可以通过
软腻萌 : 卖av的别逼逼[doge]
Y童霖Baby : 男神
茶靡问道 : 回复@源氏物語110:不管怎么说台湾自古是我们中国的一部分，如果你们真想搞个台湾国，麻烦把台湾省还给我们，你们自己在去找个地方建“国”好了。
Aggie_江雪 : 王外长迷妹签到[羞嗒嗒][羞嗒嗒][羞嗒嗒]
7_Yuan_i : 男神级人物
peksojs : 苦海无涯，回头是岸
是1个超级可爱涵 : 男神
因果循环886 : 希望有人出来查一下郑州铁路段女乘务员骗人的事
一片安眠药plus : 回复@钢铁灬加鲁鲁:一个生活在上海的人在这刷存在感？大家都骂你你有高潮是怎么的。长亭外，古道边，芳草天[doge]
乡村山上山人 : 劝某党不要一错再错，知错能改还有希望。不然机会错过，难回头。
花猫爱吃肉肉 : 日本和美国都是垃圾。
天霸动霸tuasa : 叫他们在多管闲事就抽他
宠物情缘5706144672 : 说的好爽
事事如意天天开心哈哈哈 : 王毅部长严词厉言，章显着中国的威严不可冒犯。霸气十足，支持部长有几十亿个赞[good]，支持
车狼_AutoWolf : 回复@温妮的猫窝:你陕西的吧？[嘻嘻][嘻嘻]
ufo1231118 : G20，小日本来吗？
EzioConstantine : 你先把共青团那条疯狗管好再说日本的事。
鬼马mark : [good][good][good]
云爱雨_ : 回复@圆滚滚d土豆君:在网上喊喊口号和实际打仗是不同的哦 当下外交解决是最合适的手段[喵喵]
某葱TT : 亚洲天团队长王毅
艾景贵 : 倭寇亡我之心不死！
敦促谴责 : 回复@LJ-ZZOO:你说这话就有点不爱国了！（一个来自小粉红的独白）
圆滚滚d土豆君 : 很喜欢您那股子傲娇的样子呢！我国人民就是太善良，可完全不领情的时候就真没必要。因为善良过度在别人眼中就变成了傻，好欺负，变成了东亚病夫。如果说实在不行了就打吧，国家尊严前无个人安危。相信全国人民在关键时刻都不会怂的，钓鱼岛问题就是最好证明。虽略显极端，可也是一颗颗爱国的赤子之心啊
素-寻 : 菲律宾都开始低头了日本还在这瞎搅和
HimFly : 国强靠民，而不是靠键盘。说让中国去打日本的，你知道假若打日本，全世界有多少个国家狼虎视眈眈等着掺合吗？
决然分开-贾 : 好好
快乐私语轩 : 小日本这玩的是狗仗人势，打狗不能给主人面，再说奥巴马这只黑鬼也不是好种。
无聊蹭有聊de : 男神男神男神男神男神男神[酷][羞嗒嗒][羞嗒嗒][羞嗒嗒][羞嗒嗒][心][心][心][心][心][心][心][心][心][心][心][心][心][心][心][心][心][心][心][心][心][心][心][心][心][心][心][心][心][心][心][心][心][心][心][心][心][心][心][心][心][心][心][心]全民男神[doge][doge][doge][doge][doge][doge]
Enermys : 霸气！！！
蜜丝ViVi : 日本鬼子，回头是岸
豆豆与小花 : 回复@旷野的呼喊:你能干啥
lallalllaIall : 烦死个鬼人的
冯之音 : 发现了一条网红新路线，在微博上注册一个 大日本帝国 的帐号，发一些日本的月亮比中国圆的言论，每天的拜访量一定领先全网络啊，方正我没事就会去骂一骂的。
李维VVV : 回复@LJ-ZZOO:到他们这个工作级别了，一切都在国家与国际关注下。这些可是能在历史留名的人，你认为他们还会贪这点蝇头小利吗？你怀疑也要看对象好吗？脑袋是个好东西，大家都希望你也有一个。
温妮的猫窝 : 在皮干直接撸
爱小时幻 : [笑cry][笑cry]请作为外长的粉丝，不要在评论区“tm”“卧槽”这样的吧，我们都要做高素质的后方支持[害羞]
乔兮悅儿 : 这个太特么适合我口味了。不要怂。就是干
G拖拉机赛车手 : 回复@源氏物語110:你就是一智障，咋了国民党死了台湾省就是你们什么民进党之类党派的了？我告诉你国民党死光了台湾省的地也是中国的，你用着中国人得繁体字用着中国的姓你不承认是中国人？你连自己祖宗都不认了你还说什么，我跟你说对于你这样的人不是你不承认你是中国人而是中国人民不会承认有你这样的败类
宋凯航_Keith : #逍遥（跨次元IP《长生歌》推广曲）[音乐]#oo
狐狸要变长头发 : 没完没了这几个字叼炸天
FTD_DNS_Zzx : 外交部实力圈粉
熟睡的婴儿201607 : 霸气
王列艺 : 回复@Berry-be:回复错了 [悲伤]抱歉啦
王列艺 : 回复@Berry-be:这是我兄弟
TOP君爱你知道吗 : [太开心]偶像偶像
卖奶盖的小女孩 : 回复@不要因为习惯了黑暗就为黑暗辩护:嗯，肺都给他快气炸了
KKKKateeeeJang : [微笑]悬崖勒马
987654ni : 一言不合就炸它！
987654ni : 哈哈哈哈
我会很有钱我会很漂亮 : 回复@陨俗:➕微信么
卖奶盖的小女孩 : 回复@打鼠喵喵侠owo:你这种人就是他妈的崇洋媚外，美国是你家，还是美国人是你爸！你这么帮着美国，有那个本事，你就离开中国，回到到你美国爸爸的怀里去，要不然小心你这些白痴言论被人关注后人肉，到那时，你的美国爸爸都帮不了你
一条鲜艳百搭的红领巾 : 可以的
不要因为习惯了黑暗就为黑暗辩护 : 回复@卖奶盖的小女孩:就是！宝宝乖哦，别生气了，我们不跟不懂外交的人说话了哦～@旷野的呼喊
陨俗 : 回复@我会很有钱我会很漂亮:哈哈哈哈哈哈哈哈……姑娘早点睡[doge]
我会很有钱我会很漂亮 : 回复@陨俗:我老婆借你十分钟
t-栗阳 : 回复@LJ-ZZOO:你们想把好官都赶下台吗？能办正事才是重点吧？不要人家在外面辛苦扛战，你们吃饱了，就来断后路。有本事，你去扛。
最后壹次凤凰花 : 66666
YSHUNRC- : 外长手好圆[哈哈]
苏州会粹 : 我真的不想当汉奸!双面苏绣是中华民族的国宝，运用到纺织品服装上是会粹的专利，改革创新，发展纺织品服装行业，让中国引领世界是会粹三代人的梦想，二十多年的坚守，八千万元的投入，百万次的尝试与失败，说多苦就有多苦！当今外国公司要买断专利，国内公司却如若无睹！我该何去何从？
ALIENLNG : 南海一点都不能少 国内呢？
陨俗 : 回复@我会很有钱我会很漂亮:另一个是？
小桑可人儿 : 这是我新爹地[偷笑]
我会很有钱我会很漂亮 : 回复@陨俗:不同新闻。看到你俩次…
陨俗 : 男神威武[心]
护花大叔一枚 : 回复@不可治愈的重度拖延症晚期患者:我去66667[眼泪][眼泪][眼泪][眼泪]
卖奶盖的小女孩 : 回复@旷野的呼喊:#南海仲裁案#你叫你家居委会大妈骂个试试！ [生气]懂不懂外交啊，不懂别在这瞎掺和，哪凉快那呆着去，被那些厚颜无耻的日本人看到，人家还不笑死呢，也不怕受国人耻笑[鄙视]
钰如m : 我们男神有13亿群众支持，你小日本算个卵啊[doge]王之蔑视[doge][doge]
手机用户2593561407 : 回复@LJ-ZZOO:你是有病？你怎么不公示下财产？
香香香bb : 王部长:一边去！[微笑]
香香香bb : 我们王部长不想跟你玩[拜拜]
邹馨慧- : 新晋男神
4LonelY : 突然觉得最近有王毅两个字一定是我男神说了什么了不得的话[doge][doge][doge][doge]立马狗腿的点进来看[不好意思][不好意思][不好意思][不好意思]
_伴狼 : 回复@LJ-ZZOO:啧啧
谁不爱煎饼果子 : 回复@源氏物語110:不管你们是来自于哪里，台湾都属于中国，就算你们是火星人，台湾也是中国的
妍妍_Sweet : 说的好，没完没了
只此一山住伊人 : 嘿嘿嘿，祖国的腰杆子硬起来了[爱你]
你的暱稱真土 : 回复@男大介君:日本狗吧你
不要因为习惯了黑暗就为黑暗辩护 : 回复@公子无双丶倾宇:完全被奴化的思想…我这么大岁数了还是头一次听说人权是国家给的。小姑娘你知道你在说什么吗？你得先百度搜一下国家的定义。
古道鸦 : 回复@同学王云:他都可以做你爷爷了吧
吹着风扇的土豆 : 这手势：你他妈有多远滚多远！滚犊子
甜味中的鲜美 : 风口浪尖上的中国利刃！大家多多支持他才能让他更具锋芒！秒杀倭寇海鬼以及白头鹰[嘻嘻][嘻嘻][嘻嘻]
沂蒙闲言碎語 : 在多嘴就干你[哈哈]
李瘋子llll : 回复@源氏物語110:快去找你的日本妈妈[doge]
楚楚楚_Luo : 王伯伯都这么老了希望他身体一直棒棒哒活到一百二十岁成仙[兔子][兔子]我们都需要你祖国也需要你
不要因为习惯了黑暗就为黑暗辩护 : 回复@氰勒个果:评论里90%都是追星哈韩的脑残，你跟这些人讲文化讲逻辑？
JUEXI6 : 王老师说了，不要开不能药方！
就爱锅包肉肉 : 男神[鼓掌][鼓掌][鼓掌]
不要因为习惯了黑暗就为黑暗辩护 : 回复@氰勒个果:我在想这些脑残粉如果看到巴马马文件会是啥表情…
男大介君 : 王毅[弱]
蔻辰genggeng : 今天的中国绝不是以前落后就要挨打的中国，战乱带给整个华夏众生的痛苦祖国也早已深痛的体会过，凡事主张走和平发展之路，但并不意味着会步步退让！肆意挑衅国奉劝不要得寸进尺！中国绝对先礼后兵！此时同胞也一定要团结一心，一致对外！
其实很难32315 : 男神！我来啦！！！！！！
糖糖糖糖糖小-雨 : 回复@氰勒个果:不谢  学好国际法  学好法律估计你的智商会正常
蔻辰genggeng : 摘自人民日报微博：甲午战争122周年，历史依然让人警醒。甲午一战多慷慨悲歌之士，奈何腐败横行、军纪废弛，训练造假，战舰经商！镜鉴甲午，图自强，守海疆，也更能明白军中反腐的深意。军人只有训练有素，才能随时应战、百战不殆；只有忠贞不渝，才对得起肩上的重担，守得住脚下的疆土！！！
变色的蜥蜴的夏天 : 这是我的崇拜者。
Carmen汶汶潴 : [嘻嘻][笑cry]霸道外交
何攸之 : 小婊砸，还没完没了了是吗[doge]
哒哒夫人 : 这就是我一直关注的世界最帅组合中的王毅部长[飞吻][飞吻]没错 我就是一个超级大迷妹[花痴][花痴][花痴]
随手一打就是一个霸气的网名 : 我男神果然帅炸
鸡涌家的一只猫 : 王毅是我们院长的学生呢！骄傲啊[爱你]
夏木桔梗酱 : 首位男神[心]
氰勒个果 : 回复@糖糖糖糖糖小-雨:谢谢你的夸奖
阿利呀9 : 我男神
凯宝哒幸运符号 : 好样的[鼓掌]
旷野的呼喊 : 这种骂街式外交，我们居委会大妈也能干，保证骂得更精彩。
爱鹿哥的好孩子 : 王毅部长[傻笑][傻笑]
wosadasa : 吹逼大国[偷笑]
dramas_ : @我们许过的愿听的歌游的河_
ll白0i : 怎么能帅成这个样子[吃惊]
糖糖糖糖糖小-雨 : 回复@氰勒个果:愚蠢 无知
森森森森林林木 : @美肚莎娃
源氏物語110 : 回复@hfcjyfnnitfnk:台灣人佔了中國領土台灣~美國人佔了中國領土華盛頓~日本人佔了中國領土東京~菲律賓人佔了中國領土馬尼拉~泰國人佔了中國領土曼谷~我睏了~~~~~
糖糖糖糖糖小-雨 : 回复@钢铁灬加鲁鲁:你学过政治  学过国际法吗  知道为什么不能轻易动武力吗  知道国际公法关于战争与和平怎么规定的吗  政府为了保护国民做了多少  你去看叙利亚  伊拉克现在结果  动用武力最后害得是谁？拜托吧国际法学好再来陪评论
帽子1920 : 王之蔑视
小蜗的星空 : 霸气威武[good][good]
源氏物語110 : 回复@英明神武的松哥哥:這是史實~
英明神武的松哥哥 : 回复@钢铁灬加鲁鲁:你是屎就不要把中国当粪坑
慕北Grace : 回复@钢铁灬加鲁鲁:那你更是个垃圾[弱]
意-M : 我们不是甲午战争的中国了
胖三斤啊哈 : 我大中国的男神啊[噢耶]
樱桃小丸子爱学习哒 : 日本你们不想饿死乖乖听中国爸爸的话[怒骂]
英明神武的松哥哥 : 回复@源氏物語110:你们台湾省的人说出来的话总显得低人一等，也许是因为日本人杂交的原因
耀怡_ : 日本人就是屁事多[拜拜]
白晓晓小公举 : 回复@LJ-ZZOO:看你就有本事查出来，去查啊～
无聊浸猪笼 : 王毅我爱你，牛逼，也就你能这么直白说出他们的不要脸了
漂洋过海来看HCY : 当初在我中华践踏国土，残害百姓的恶行简直人神共愤！这是小日本的根！改不了！此事别太凑不要脸，灭了你只是早晚的事儿[拜拜][拜拜][拜拜]
Okaykaka : 回复@钢铁灬加鲁鲁:那是哪族人？呵呵呵 我就搞笑了 那么喜欢美国 你工资哪国给你的 你读书哪国供你的 看多好莱坞了吧你
慕北Grace : 回复@源氏物語110:傻屌[微笑]
三爷三爷总攻 : 回复@LJ-ZZOO:人家凭什么公布财产，你有什么权利要求人家这么做，逻辑错误，节奏零分[doge][doge][doge]
hfcjyfnnitfnk : 回复@源氏物語110:你搞错了。。 我们想让台湾回归是想让台湾有三观有良心的人同胞和台湾省土地回归 。。跟你和你那些台独分子没什么关系 。。你们随便 你们快点走吧好吗 为什么要占我们的宝岛不走。。？？
打鼠喵喵侠owo : 回复@钢铁灬加鲁鲁:有本事滚出中国啊，没你中国爸爸你有啥资本在键盘上bbb……你怎么知道中国只警告没行动，不知道你脖子上顶的是什么玩意儿
取个撒子名字给兰明星 : 回复@钢铁灬加鲁鲁:🙃🙃滚
朱22_ : 新晋男神[爱你][爱你][爱你]
sherlock-你又不是卷福 : 回复@源氏物語110:发现一个zz
魔骢 : 只有警告有什么用吗？中国应该更加强势，用一些行动告诉日本！
小凡大懒锅 : 回复@钢铁灬加鲁鲁:你他妈不是中国人，你这么厉害怎么不上天，还玩微博?
zico燕子 : 回复@钢铁灬加鲁鲁:老子一般不评论谁，但你这样的垃圾真的是欠骂，滚你美爹那去，少在你爸爸面前丢人现眼
源氏物語110 : 回复@sherlock-你又不是卷福:不好意思，台灣已經被台灣人佔領了，國民黨等一干中國人現在即將滅亡，你們趁早把你們同胞國民黨接回去吧~
Mr-Tang911 : 好好造车，好好拍AV。别无他求
林大小姐kill : 男神
刘星宇DIY : 意思别给脸不要脸
Hellozeno : 回复@钢铁灬加鲁鲁:你也是垃圾[微笑]
sherlock-你又不是卷福 : 回复@源氏物語110:去吧，回东南亚，地留下就行[微笑]
DDDD猪头didi : 王大大严肃起来真的很帅，笑起来很可爱[爱你]
让小强带你飞 : 王曰：我不至态度上很硬，我某个地方可以更硬。
钢铁灬加鲁鲁 : 也就bb一下了，中国早晚有一天还是要被美国殖民的。毕竟汉族人是个垃圾民族
诺诺4120 : 台独分子滚出去好么，不要用着中国字来这bb  ok?[拜拜]
蝴蝶的开心时光 : 霸气
大硕欧尼- : 帅气[good][good]
蔚蓝薇蓝花开花落 : 日本倭奴这张狗皮膏药老粘着人干嘛
小白龙马 : 总有智障来刷存在感[微笑] 在现实生活中是有多失败窝囊，才把所有怨气发在社会身上[挖鼻] 不要因为自己是条蛆，就把社会当成粪坑[挖鼻]
夜凉幽篁 : 没完没了这四个字虽然用的不书面，但是很王毅[doge][眼泪]充分表示了王毅部长那种看着熊孩子瞎折腾的蔑视[doge][doge][doge]
LH234 : 我们自己的是关你日本毛事，别没完没了，都他妈得滚蛋，我们中国不吃你那一套[怒]
野行_1015 : 王毅并不想跟你废话并给了你一个严厉的眼神让你自己体会[害羞]
公子无双丶倾宇 : 回复@内不内谁么:是的，只要中国人有这个自觉性真的少去日韩旅游，不要买日韩的化妆品，不去促进他们经济发展，还真会影响他们经济。
diangdiang子 : 日本骂都懒得骂了🙄
耿耿耿耿耿耿耿耿耿心 : 评论里一群脑残粉[笑cry][笑cry]不过我是喜闻乐见[哈哈][哈哈][哈哈]
生莫Elan : 再不听话，爸爸将亲手送你上火葬场！霸气！
Jessie是胖达 : 回复@氰勒个果:自己人身攻击别人，还显得自己很厉害一样，我只是说你可以你上啊，既然不满意你就上呗～～做出一番事业给我们看看，也打打我们的脸好了～～～我就是小粉红，不服气你也只能打打嘴炮过瘾啊。随便你怎么喷咯
我竟无言以对呵呵呵 : 王之蔑视[鼓掌][鼓掌][鼓掌]
聚胜窗饰 : 回复@LJ-ZZOO:公布正义就行了，财产不需要你来知道！
V-mengsi : 我男神，霸气[哈哈]
項紫怡- : @白淑琪- 哈哈哈哈
氰勒个果 : 回复@Jessie是胖达:粉红豚脑癌晚期，粉个太监还感觉良好，你姓赵么？
以前以后Tianc : 不要没完没了 霸气。
公子无双丶倾宇 : 回复@人脑全自动玩具高智商版:我住在南京大屠杀纪念馆附近，每年的12月南京都拉响警报，太有感触了，真的，不管中日以后怎样，心里真的无法原谅他们，永远无法原谅他们做过的事。
公子无双丶倾宇 : 回复@源氏物語110:吃着中国给予你的饭，用着中国提供给你的物料，享受着中国给予你的权利生活在中国的土地上在这边说风凉话，可以这么说，如果你不是中国人，如果不是中国护着你们，早就被强国干死了，不管怎么说，台湾就是中国的，你们爱住就住，不住就滚出去，别赖在别人家里还在这边大放厥词
会飞的布偶猫 : @韩艺丰YA [笑cry][笑cry][笑cry]
周瑶妹妹 : 6666666666
我的的宠物小蟑螂 : 回复@LJ-ZZOO:你真小学毕业？
饼饼xi : 十一区，警告你了哦[微笑][微笑][微笑]
G-fish在倒数人生__ : 卖三文鱼的，爸爸和卖香蕉在讲话你别插嘴[doge][doge]
Jessie是胖达 : 回复@氰勒个果:有病就去看～～
氰勒个果 : 回复@Jessie是胖达:你被他临幸过？
罗骋 : 部长大人威武
差不多班长 : 霸气加帅气[good]
吳嘉嘉呱呱 : @岑双荣 叫你说晚安 你...
晴雨初华 : 看不惯一些搅屎棍的评价
许是路人或是老友 : [挖鼻]
蘇靚 : 呵 小日本滚蛋～别没完没了的烦我们王外长～我们外长要休息不想理你并向你扔了一坨翔
怎么怎么又怎么 : 我单方面宣布这是我老公[doge]收获热评里好多儿子女儿[doge]
源氏物語110 : 回复@Lange_HL:中國是侵略者，而且琉球並不是中國取名的，因為琉球當地有原住民，不管是琉球的原住民或台灣的原住民，都是從現在東南亞國家往北遷徙，並非來自於中國~
优美服饰8899 : 应当这样说，你小日本作为一个战败国，应当与邻居友好相处，现实却是傍着美国主子的大腿，到处兴风作浪挑起各种争端，只想问你一句，被原子弹轰炸的滋味不记得了吗？！
Jessie是胖达 : 回复@氰勒个果:要不您上？
戏月瓶神 : 太帅
90后的调皮鬼201604 : 我们帅气的外交部长讲的好
Bella韋柳芸 : 屌[赞]
KaKa的夏天来了 : 王毅老公
ybb不装逼 : 干他娘的一炮啊。
嗨v傻瓜 : 感觉外长真的压力好大好累、希望这些烦人的事能尽快了结     让外长能好好休息
Iruriii-Z : 日本会不会转身告状中国爸爸当众威胁他
小龍人ZHUA瞌睡 : 就喜歡部長這麼不客氣
Choco-GAHO : 不要没完没了[强壮]
氰勒个果 : 这个太监整天说这些废话有什么用？
这个人太聪明没有名字 : 部长有没有微博[喵喵][喵喵][喵喵]
这个人太聪明没有名字 : 小日本[doge][doge]我们部长发话了听见没有[doge][doge]哪凉快哪呆着别到处瞎BB[doge][doge]
LAY雪儿 : 王毅  真是帅呆了  爱死你啦
Endlessinspiration : 说了等于没说
跌倒的橘子 : [爱你]男神，一生粉
Nobodyuse : 霸气(°ㅂ° ╬)
孤岛上的寒梅 : 说话就需要这么狠，要不然别人不把你当回事
对酒当歌92659 : 回复@热血黑妹5 的赞:[嘻嘻][嘻嘻]小日本它是怕中国不乱！祖国稳定南海！小日本安稳日子不长了！
庆庆宝宝x : 对日本就是得强硬，爱豆说得没错
阿芠予哲wz-lovekylin : 我跟你说你憋不服  你真不服你就给我滚出去[doge]
琉璃光塔琉璃光 : #我只是一个人的脑残粉.他的名字叫中国#    看我外长大大王之蔑视[doge]
方方土KL : 终于可以不用忍了，硬起来！
死宅葳 : 帅出天际
湿妹下面不湿不好吃 : @湿妹下面不湿不好吃 需要盘盘么[来][馋嘴]你懂的
倦你们 : 一看年轻就非常非常帅，[害羞]
羁罗 : [鼓掌] [鼓掌] [鼓掌] [鼓掌] [鼓掌] [鼓掌] [鼓掌] [鼓掌] [鼓掌] [鼓掌]
徐天longgg : 第一个政治偶像
包子包子哎 : 手势的意思大自是:门在那边 ，[日本]自己滚。
墨瞳丶丶 : 外长真帅
QvQ就要这个昵称 : 门在那边[哈哈]
PsychologistR : [爱你][鲜花]王部长威武！
Mr私制钞 : 一边玩篮子去，有特么你啥事。王部长如是说
不再犹豫VENA : 奉劝了多少次多少年了，打他小日本啊
五三林润鹅 : 王毅的气质真的很适合代表中国啊！
逾时不候wait张三岁 : 南海问题 和日本有半毛钱关系嘛 日本是不是被震傻了
人脑全自动玩具高智商版 : @过大宝 今天整理照片看到一些日军屠杀的照片，人头摆在地上的…我说这些就能证明他们在撒谎了，英国同事都知道日本政府的作为[斜眼]
原地等候春暖花开 : 帅气
张_月_ : 卖av的出去
槡梓地 : 没完没了用的，是有多嫌弃啊[笑cry][笑cry][笑cry]
方星哥 : 帅气[赞]
对酒当歌92659 : 小日本要乱发话！建议给他个核弹吓唬吓唬它！不然它跳得有点出格了！
Cherrybam_ : 成天顶着个大姨妈国旗真是了不地了[微笑]
嫣然蓝如雪 : 就应该多大点这样的新闻，什么赵薇，什么文章姚笛，都是什么鬼。这些人都统统爱干嘛干嘛，不要总是占着热搜。不想看到太多明星的屁事
A莉莉宝宝 : 王大大现在帅帅帅，年轻时得帅到什么程度呀。
再见Links : 中国有本事了，外交部才敢傲，加油，好样的！
迷人的午后 : 看到过的最正最接地的大国外长，帅爆了！
李苟淡灬Sherren_Lea : 回复@Student-XZ:不是卖黄碟的吗[笑cry][笑cry]
芳芳75909 : 讨厌日本
原味儿Yana : 瞬间被秒了
到处漂的猫 : [爱你][爱你][爱你]不愧是我喜欢的人[害羞][害羞]
有风有雨就好 : 俺们就是牛B，你们的想法俺懒得听，反正你们一定要回到我们认定“正确的”轨道上来。不商量，不妥协，老子就是自信。
诗诗诗诗婷_菌 : 帅气[羞嗒嗒][羞嗒嗒]
VekaChau : 男神
郑新鲜 : 我已经放你一马了，别再把脸凑上来给我打了，我是有理由打你的知道不。[微笑][微笑][微笑]
菁菁妍 : 牛牛牛
小点心的妈咪唷 : 威武 霸气 睿智 大度 集于一身的 王伯伯[飞吻][飞吻][飞吻][飞吻][飞吻]
嘁嘁喳XD : 很强硬的发言啊，基本算对呛了…
多快好省地建设社会主义一流大学 : 历史已经证明了无数次，这个民族连狠狠地打他们都不长教训，为什么还要谈话？谈话有个鸡毛的用？（顺便赞一下王外长）
李瑞80808 : 这是我男神，都他么的让开
kayee-siu : @kayee-siu：王毅男神辛苦了！注意休息
rammed : 日本儿砸又不听话了
仿佛带点唏嘘7139 : 我突然好想念周恩来总理
Bye-n1 : 天团又发话了 哈哈…
Jnfmdaims : 学学普京吧
RilkeanHeart7 : 回复@第十三生产队小牛:噢？所以说不过别人就开始人身攻击了？早知道你就这点水平 不和你白费那么多口舌[微笑]
一醉解千愁icon : 偶像 偶像啊[笑cry] 帅死了 给你一百个赞[哈哈]
兔子便当里的--凤梨怪兽 : 食指是标志性动作[偷笑]
第十三生产队小牛 : 回复@RilkeanHeart7:也不知道你亲爹怎么想，来这边还有几朵菊花，一起送你舔
越美的微笑_越容易沉迷86266 : 下次就不是竖食指这么简单了
KCPDM4 : 别给脸不要脸
很久没有改过微博名字了哎 : 迷妹脸
手机用户3465841094 : 日政府真贱 跟小梁小丑一样没完没了没皮没脸
长腿毛蜀黍 : 回复@Phoebe_hh:国家的强大现在深有体会
Peacemimusone : 我们部长[好棒]
缘思考 : 王部长和日本对话不对抗，评论里倒先对抗起来了。[笑cry]这里面一半以上关注到王部长的帅，情欲多过情绪，少部分和几个异己分子语言对抗，一部分事不关己，一部分推波助澜。这就是未来战争的一面照妖镜。[晕]
杨孜墨 : 男神[爱你]
羽蒙grace : 男神[爱你]
拾荒者Lun : 今年最帅最霸道的男人就是他了，同意的赞我[拳头][拳头][拳头]
请叫我女王大人-ymm : 给我毅哥大写的赞[强]。
令狐冲的妹子06 : 再bb就不买碟了[doge]
起名废_烦躁 : 大大帅炸！！！！啊啊啊啊啊[抓狂][抓狂][抓狂][抓狂]怎么可以这么霸气！！！！！
GUARDROY : 帅气逼人，国名干爹[赞][赞][赞]
RilkeanHeart7 : 回复@第十三生产队小牛:excuse me？你的意思是任何词语只能用其本义？那“八卦”你还只准它有古代的意思是吧？说起来，人云亦云这个词儿，你知道出处吗？[微笑]
Win厸_ : @HsLyl1120
奥利奥没夹心儿 : 应该多些这种敢说话直白的人，我们国家做事就是太委婉，都以为我们好奇du
第十三生产队小牛 : 回复@RilkeanHeart7:自己查查出处吧，人云亦云
冀蒙嘉星 : 干得好
邱小邱姐姐 : 没完没了[怒]
喵dool : 日本根本不会鸟你～
小念家的乔子阙 : 外长威武[微笑]
VANILLA_FISH : 🤘🏻🤘🏻🤘🏻
DavidWang看新闻 : 呵呵[挖鼻]
Iynette-- : 好帅！
Amile要向K国奋斗FL : 男神[推荐]帅就一个字[推荐]
差不多Z小姐1992 : 鹰派威武[good]
天山松zzq : 日本人应下跪反省对中国犯下的涛天大罪，见到中国人应该「哈咦」！少逼嗒嗒！
小小小宥睿 : 真的是没完没了，关日本P事，啥都要来插一脚
善良的-33 : 太对了！别没完没了！
鹿野迷踪 : 硬气一点[doge][doge]
呆兔太幸福 : 回复@手机用户0000725:什么新闻[馋嘴]
大颢子 : 替部长大人翻译一下：别给脸不要脸[拜拜]
王小丹大玮 : 国民男神[酷]
黑和蓝 : 回复@海之蓝133:看这骂人的劲儿，应该是你的嘴巴臭吧。
初糖怪杰和红粉骷髅 : 只要停了所有日货的进口，所有的日本旅行，日本就老实了
德芙超级酸 : 日本政府真的是很不要脸
蓝色枫叶LYF : 帅炸了[doge][喵喵]
哈哈张吉祥 : 王王王王……
KrisssCyeolll- : 王毅帅气[羞嗒嗒]
-橙子喜喜 : 好帅(⊙o⊙)哦[心]
-久伴与你 : [doge]你不要给我搞事情
秦华_nin : 小日本，要学乖点
LLIJIAYIN : 对日本的言外之意：管你毛事，滚
起个名字怎么那么不容易 : 我是王外长的脑残粉
永远的蔚蓝2016 : 王外长你别急，小日本就不咋地。死缠烂打鬼上身，狗皮膏药会粘人。合纵连横策略多，破解亚洲小北约。
JusqinBaby : 帅呆[爱你]
不服放学等你 : 是时候开战了
花子_HUAzi : [微笑]
蓝翔铲屎机技术学院校花 : 太帅了…[哆啦A梦吃惊][哆啦A梦吃惊][哆啦A梦吃惊][哆啦A梦吃惊]
叫我兔子大人_ : 看见祖国这么直白我就放心了[微笑]
陈雪了个琪 : 好酷[色]
wow_小EE : 欠日
时光efnigx : 外交部长面相难看
河南魔王松鼠 : 这才是中国该有的霸气！天天仁义礼智信的没一点屁用！
会计师2891698717 : 王毅大大才算是前无古人，霸气侧漏，重振我中华。
捉鸡逗逼 : 回复@泥酱韩:[嘻嘻][鲜花]
因我极心痴 : 回复@LJ-ZZOO:你是有多阴暗？仇富的都是屌丝，就算你有钱也是个屌丝，不如自己心态放平和一些[微笑]
我不高冷我高寒Y : 男神[心][心][心]
镜与云清 : @公公SAMA 看评论哈哈哈哈哈
叁少_陈 : 不要再打口水仗了！我们是中国[中国]
小福是昵称 : 新一代国民男神！[心][爱你][哈哈][哈哈][哈哈]
唐尧Fly : 现在若是干日本[日本]，我就不退伍了！而且我会不停地练练练，练到踏上日本国土的那一天！
AA12全自动散弹枪 : 日本这个国家看它不爽18年，血债血偿，肉债肉偿[色][色][色][色][色]
nabern : 牛[奶牛][奶牛]
珞珈LUO : 意思就是跟日本说：关你屁事，滚远点[拜拜][拜拜]
仁寿信息网 : 回复@李尧courage:粗来
luwanwan_ : 热评那个说公示财产的 特么什么强盗逻辑 小人之心度君子之腹 mdzz[微笑]口气酸得不行
古有此人 : 劝君只扫门前雪 勿管他人瓦上霜
佞佞姐ZN : 给脸不要脸了是吧小屁孩儿
白日梦小妞_Caramel : 没完没了我给100分
是李念呀 : 回复@栗子Cherish-:评论里都是情敌呀
你说的笑话不好笑ll : 碍你小日本什么事！
庄懵懵 : 没完没了！了还！
你好吗ciyi : 全中国就你最帅了[good]
安2503 : 帅爆了！男神！
薛妖怪and田净值 : 还没完啊[思考]
贝加尔游骑 : 抓住了别人的睾丸，小日本能不急吗？
AA12全自动散弹枪 : 咱多咱也进东京爽一把，百鸡斩兔子106-105折耳兔，因为不知道哪只兔子先斩100只鸡，择日再来一次[doge][doge][doge]——种花日报。还有啊，把东京优质母鸡集中起来建立兔子安抚所[阴险][阴险][阴险][阴险][阴险]
玉雪精灵 : 转发微博
官官大人1995 : 霸气[哆啦A梦花心][哆啦A梦花心][哆啦A梦花心]
Heidel海德 : 回复@LJ-ZZOO:你若心有不平也要记住，他们的能力和他们的所得是相匹配的，he deserve it.
Phoebe_hh : 回复@长腿毛蜀黍:因为以前不够发达，不敢说话。哈哈哈
大哥天生傲骨 : 大王霸气
关于我最喜欢的你耶 : 大大您好我是你的迷妹
龚GGGSW : 小人才会多管闲事
请叫我闹闹yy : 王同学，说了，你在BIBIBIBIBI，别怪我们把你的填海陆地计划给弄泡汤，给你继续扔一堆海星过去
龚GGGSW : 偶像！！！
汉阳公主的苍头 : 王毅外长我男神!
你看我理你吗啊 : 这很强势
有爱心的人会有人爱 : 日本就是倭寇。倭寇就是不是好人。不安好心
黑猫与红狐狸 : @wuyiiiii酱 周围吃瓜国好多戏[doge]
李尧courage : 团长好我是你的迷妹
败家爷们82645 : 大气，霸气。。
90後辣妈icy_Nuskin : 都不知道什么时候开始被我们的国家领导人们圈粉了，迷的不要不要的，太帅了
有爱心的人会有人爱 : 美国当年打了日本人就是知道日本人有想统治地球的想法。日本人就知道挑事。没安好心
94年11月20日 : 别忘了还有个韩国，日本是明着和我们对抗，韩国棒子是阴我们，背后捅刀子，先骗我们赞成制裁朝鲜，等中朝关系冰点了又说我们对不起它，引入了“萨德”，就算我们再出力制裁朝鲜了，下次还是会拿这个威胁中国，迟早会引入，中韩只能经济合作，其他一概不行，毕竟不同阵营，而且韩国民间反华比日本还严重
敏心之旅 : 今天在上班的时候看见了男神就定住了[可爱]
王兆信学高数 : 回复@青春短句:[钱]
我住在鹿森林 : 我们不约[微笑]
尧暮宣 : 傻日：我脸皮厚怪我？还不是被日肿的！
qiao舌ru簧 : 够霸气！！
Quailface : 哈哈哈哈男神@吴狗蛋233
潘梓浩啊 : 可以，这很王毅
Final_Interfce : so what？[汗]
青轻诉说 : 翻译过来就是，已经说了不想理你，别蹬鼻子上脸[微笑]
SuDawson : 男神霸气[good]
yogalxx : [嘻嘻][嘻嘻][赞][赞]男神[心][心]
荼hunlay : 配图OS：那边滚[微笑]
GEM-二宝 : 我的男神[爱你]
你女朋友哎嘿 : 男神
林烁YL : 我男神就是帅
萌萌的大力 : 真男神
于三三三三三 : 小日本鬼子[拳头]
赚钱给我哥买装备 : 怎么办脑残粉了[笑cry]
尤克里里的契约 : 王毅最帅
腐女贰号 : 没完没了！[眼泪][眼泪][眼泪][眼泪][眼泪]
最爱的人是绵羊兴 : 爱你[心]王毅大大
Baby木子倩兒 : 王部长就是霸气[可爱]
淡然若秋水 : 在反华,辱华,排华事情上日本绝对会不遗余力，没完没了的，因为这是它的既定战略。
小赵船长 : 我TM一个天天呆家里打游戏的臭屌丝都觉得这些国家神TM烦
内不内谁么 : 嗨呀，说菲律宾是卖水果的，说日本是拍黄片的，动不动就是中国不买你东西你国家经济分分钟崩溃。秀这种莫名其妙的优越感真的不会觉得尴尬吗？
大写的肆_ : 人家菲律宾都在求和了  日本还在没完没了的哔哔[doge][doge][doge]
tsyhust : 日本成了狗屁膏药
渐久龙图 : 新偶像
长腿毛蜀黍 : 真是时势造英雄   以前也没觉得部长大人那么霸气啊！
不再年少的刺客君 : 快要成为迷妹了[微笑]
HM_Lever : 表白我男神
侯莎莎Ven : 想当年我们大中国穷的叮当响的时候都能把你们打跑，以现在我们大天朝的水平  真不知道小日本脑子是不是有病[doge][doge]
鹿哥哥a : #鹿晗#王毅又帅出新高度了@呆萌的壞壞的蜀黍:意思告诉你再没完没了爸爸就要打你了
WY-vvv : 可以，这很王毅
二万V : →_→[色]“塔西佗陷阱”得名于古罗马时代的历史学家塔西佗。通俗的讲，就是指政府部门一旦失去公信力后，无论是说真话还是说假话，无论是做好事还是做坏事，都会被认为是说假话、做坏事。这卓越的见解后来成为西方政治学里的定律之一，亦称“塔西佗效应”。
十方涌泉 : [祈祷][祈祷][祈祷]
Mister-丁小小 : ta的目的就是要没完没了地骚扰我们啊[囧]
我是菠萝忘了长刺Oo : 转发同送给隔壁卖泡菜的[微笑][微笑]
东海道的小花朵 : 棒。
Student-XZ : 一个卖汉堡的和一个卖寿司的非要怂恿一个卖香蕉的耍不要脸，搞不明白[挖鼻]
影清之影 : 这个姿势是说，捣乱的请出去！
菜大头yuxin : 之前觉得周恩来帅的不得了。现在看，又要多一名帅帅的同志了。
dtxubc : 操，拜托你说人话
7hZ葵 : 日本搅屎棍，根本就不关他的事，也要插一脚，是想从中谋取利益吧！
叫我萝少 : 好霸气，天生的外交部部长
梓娇-Kim : 您帅，说什么都对[偷笑]
叫我萝少 : 真帅[哈哈]
因你而在v7 : 男神
Doc_Chan : 回复@意大利足球新闻:明白人，现在中国不怕搞事了，说明国家开始强大了
dieciseis16 : 男神男神男神
弱水三千唯取乔 : 王毅大大就是帅啊~
风吹暖了花 : 中国一点也不能少
发微博的桌子 : 然并卵
TrachU : 给你个眼神自己领会
Dr-Bazinga : 年龄真真的不是距离，所以......[害羞][害羞][害羞][害羞]
二道饭店小奶油 : 好好务实拍电影，大国的事跟你没关系
Charles--Luo : 意思大概就是 关你屁事！
阮粢 : [微笑]用张启山的话:别以为吃了几个中国菜，懂了几句中国话就以为自己很了解中国。你连小学生都比不起。日本，好自为之。
__祖国的花骨朵 : 霸气帅男神
琳公子有颗Bulletproof-heart : @琳公子有颗Bulletproof-heart: 国家该强硬的时候就强硬！看到王毅部长如此霸气我也就放心了，新晋全民男神[微笑]。Ps：刚刚被马原史纲毛中特思修洗脑了几天，觉得我党还是挺棒的[嘻嘻]
古风驼 : 日本:中国什么时候开始说话不委婉了，这也太直白了，噎人。
Calanina : 帅炸 男神
誠懇青蛙 : 好[偷乐][doge][doge]
M淡淡的happiness : 当年还打不够吗？如若要继续打奉陪到底～小日本，滚回去好好卖你的黄片去～
哈哈哈琦琦琦琦 : 男神有立场有担当！
Rie_Tanaka : 回复@大前雷子:哈哈哈哈，福建省泉州市日本县
LIANLIAN_闫萌 : 男神，太崇拜你了[爱你]
怎么酱紫啊 : 太酷了吧[爱你]
LUOJIANaaa : 男神
M__S- : 没完没了，四个字我喜欢，潜台词就是给你台阶你真要上天啊
喵喵-喵喵喵233 : 讲如果，日本曾为了发动战争付出过惨痛代价，今天还敢拿什么嚣张！麻蛋！！
陶buling : 小日本是鸡下巴吃多了了，哪哪都有它，哪哪都要来插嘴，要不要挂墙上啊？
L_火山的柠檬贤儿 : 没你事别瞎BB[微笑]
深海溺死一条鱼1798 : 王毅大大是我男神[飞吻]
兔子的快乐小窝 : [拳头][拳头][拳头]
菏泽方舟 : 历史一再证明，大和民族是最不守信誉的民族，你强大了，它会敬畏，一旦你比它弱，他就像饿狼一样扑上来，撕烂我们的肉，喝光我们的血，对于日本，只有一直比它强大，才能立于不败之地！
马利颖 : 我男神的意思是，小日本别给脸不要脸，小心给你点儿颜色看看
幸畐的女孩 : 我的男神
xixiGDragon5201314 : 男神好帅~(ฅ&gt;ω&lt;*ฅ)
我是宸宸宸宸i : 我偶像，王毅部长[爱你][爱你][爱你][赞][赞][赞][赞][赞][心][心][心][心]
一尘只在灯火阑珊处 : 这么说话很王毅，牛
Jessie-茜茜 : @喝了三杯茶还有几杯 日本也不是什么好东西 狗改不了吃屎
缩影自己 : [威武]说得好
楠-9999 : 小鬼子，我大中华现在分分钟掀你桌子[哈哈][哈哈][哈哈]
宇宙无敌青春美少男布鲁斯李 : 没你事别bb[微笑]
AyIngbaby9 : 可以，这很男神[doge]
古风驼 : 现在对外说话真的够牛。
民科代表 : 这届真不行。。。
-劉芳芳- : 大男神
ShirlyHr : 加油[左上](^ω^)[右上]干的漂亮
智商爆表的小六 : 那些没事瞎bb的，你说国家总统咋就没选上你呢，你咋就这么牛逼呢。说什么像小孩子吵架，暗示鼓励战争的，都是些什么心态，我怕真打起来了，你们极可能就是21世纪最新一批的汉奸[微笑]
永远很缓慢39646 : 你太帅  帅出中国新高度[haha][爱你]
-男鹏友 : 谨言慎行   不知道什么意思的自己百度一下  外交黑话  比强烈谴责严重的多
蜜蜜微笑 : 心里说：给你脸了啊，你tm有完没完了
L寒晗L : 部长大人太帅了[爱你]
豬肉燉粉條噠 : 那些所谓于我国对峙的国家其实脖子上都套着狗链，比如日本，遛狗的人就是美国佬，不能惯着他们，棍棒出孝子，打他们这帮狗日滴，我大中国威武
笑话像我Y : [good][good][good]
村口大仙啊 : 我们的外加部长就是霸气到爆
猫的树wxy : 中国男神[花痴]
楠-9999 : 就该这么社会！大哥讲话就是这么简单干脆[哈哈][赞][赞][赞]
石源里美 : 回复@曾经历的四月:以前中国还不够强没底气，不敢得罪。现在可以了[哈哈]
-娜姐阿- : 眉毛辣么的帅[爱心]
ImZzh_ : 杂碎日本，就是贱不过，口头警告不听，非要打起来把你灭了才服
孫倩茹 : 不要一错再错，没完没了！[good]
儿子乖过来爸爸抱 : 王毅大大越发的帅气[爱你] 王之蔑视[doge]
一口纯祯 : 直帅[爱你]
朕知道了la : 朕知道了[喵喵]
无他主义 : 我说他怎么那么帅又会穿衣服呢。。搜了下原来是我大天平[哈哈][哈哈][哈哈][哈哈]
augustmoon- : 卖碟的请出去[喵喵]
我是任小妹 : 今年就你最火了[偷笑]
不要香菜不要辣要葱 : 没完没了，哈哈，一副忍你很久了快忍不住了你别再惹毛我了不然我发起狠来我自己都怕的赶脚。王大大好霸气
流浪的小孩sgj : 过个日子容易么，有点家底就遭贼惦记╮(╯▽╰)╭
PASSERBY_浅殇 : 我是中国人，我爱自己的祖国！支持王毅！全民新晋男神！真正的男神！
曾经历的四月 : 以前说话圆滑，太委婉。喜欢这样的说话态度，直白，一击即中，有底气。
你有多傻气 : 简直就是霸道总裁范 又帅又有实力
iam-Bruce : 意思是，爸爸快要忍不住了，小心爸爸打屎你。
智多星无双 : 大国外交，就是这样大义凛然！
Idrilcele : 就差一句“別沒事瞎叨叨”了[doge]
帅帅贺 : 帅[可爱]
RO洁 : [色]霸气
LIMDOG89 : 王者风范
媛野小千 : 两个粗粗的眉毛像蜡笔小新一样 嘿嘿
冷酷蜀黍 : 男神[作揖]
--王者丑生 : 霸气啊！！！！！
地猫 : [鼓掌][鼓掌][鼓掌]@博主未满18不给撩：王之蔑视[喵喵]
潘Naive : 霸气[心][心][心][good][good][good]
良_少爷 : 这配图 依然是在训熊孩子 熊孩子是要打的 被打过后才能乖乖听使
诚实的嗯哼嗯哼885 : 中国爷们儿～
周小小川同学 : 我们的那个导弹很久没检查了  有时候会不小心飞出去呐[doge]
马小羊思蜜哒 : 王之蔑视，这个手势可以解读为 我不动手，你自己滚[doge]
种蘑菇的小铝孩 : 就我觉得王外长很有黑帮老大的气质吗[爱你]迷妹ing
小娜子zn : 小日本，你再这样小心爸爸家法处治[哈哈]
小脚趾的趾甲 : 乖乖滚回去吃狗粮吧！
二妮子哟 : 喜欢[心]
陈caocao : 霸气[good]
Dwnsfs : 我男神！
红色山地车儿 : 中国特有的霸气，这才是偶像
Michael米高- : 日本就见不得中国好，永远是中国世敌
胖晶er : 我爱王毅  我要嫁给你
三十六小时2946389961 : 回复@火星来的菜鸟:可别给中国丢人了！
c小丫丫 : 日本就是一条狗，你强大揍它一顿，它就哈巴，你弱小它就过来咬你，我们每每国家衰弱必受它侵略，这样的疯狗在侧怎能安心？我们一定要强大，灭了这样的狗才能不让历史重演！害死的日本！
ZY最爱的 : 如果王外长开微博我绝对关注，是特关。
---憨憨--- : 王毅是夜壶镶金边，嘴好！
跌不碎的钢牙Mas : 喜欢这种直来直去的讲话方式 简单明了 干脆利索 一针见血 给王部长点赞[中国][中国][中国][中国]
彦彦宝贝呀 : 这才是大国形象[赞]
Annie-ShiMei : 霸气啊[鼓掌][鼓掌][鼓掌]
苒慕 : [微笑]揍小鬼子一顿就好了
今夕何夕_200910 : 日本像个神经病一样
黄瑶瑶_f : “告诉你啊，憋没完没了地闹，老子烦着呢！信不信我揍你！”“嘤嘤，山姆粑粑，有人欺负我！”
傲娇的summer20609 : 意思就是，小鬼子，关你屌事？没你事，滚一边去，别逼逼。
火星来的菜鸟 : 日本你挺好，别bb，再bb我们也搞一个仲裁，不就出点钱嘛，咱有，日本不是一个国家，只是中国的一个省而已，这个有史为证，到哪都说得通，秦朝的时候就是中国的，变不了的，你们是中国第57个民族，大和民族嘛。
MC燕 : 就是  别没完没了[怒]
VDicaprio : 我单方面宣布王毅是我干爹[doge][doge]
太康街扛把子 : 真心讨厌日本人。
vr扬 : 习大大说：  这小子真是一点面儿不给     最近老是跟我抢帅
那我就叫徐小圈好了 : 加俩鸡腿🍗🍗[doge]
茗大大大大 : 华丽的外出  私[doge][doge][doge]
芈小星星 : 日本那损色样
一点不来悬 : 此处应该有配图[哆啦A梦吃惊]
狮城苍狼 : @杨建国: 转发微博
一阵鹿风869 : 男神，
Up要上进 : 干他们啊！
熊孩纸是我的熊孩纸 : @高高云混 能不能再帅点
玩俺疯 : 男神，霸气[good][good][good]
li亦灵 : 小日本，关你屁事，少管闲事！
张庭TST活酵母赛虎团队创始人 : 外长大人，中国人真正的男神
一粒兔 : 王毅外长有老婆了吗[傻眼][傻眼][傻眼][傻眼]
凤妹666 : 男神
-就像风啊 : 王毅大大霸气侧漏[色]
黄二丫sweety : @-小-羊-羊-
周庭幽 : 不好意思，我把祖国看成了祖母[拜拜]
小太烊GenLu : [色][色][色][色]
Mr_LUKANG : 王毅大大好帅 然而我要表白陆慷[害羞]
莫伤MOSAN : 意思就是瞎BB什么，有你什么事。[微笑]
未知数xorz : 回复@LJ-ZZOO:公示财产？那你说一下，王毅外长该有多少钱才符合你心中的清廉，这老头儿天天不知道为了谁特么得东奔西走，总理不知道为了谁特么得 走廊外交 都出来了,你在这刚正不阿得躺在家里玩着手机发微博，真特么寒心啊，不知道一夜白头特么得为了谁，想起一句挺糙的话，真特么是喂不饱的白眼狼啊[微笑][微笑]
kinn的内心 : 打它、没毛病
葫芦娃是丽娃呀 : 我的新一届男神！同意的抱紧我！[爱你][爱你]
1我叫小清新 : 男神男神男神
summerhunhun : 别没完没了了[害羞]
lady侯大人 : 为难就不能骂他们一句，不要死皮赖脸的死缠烂打来当有狗讨好美国好么～连米国此刻都在缓和尴尬
青青_我的宝贝928 : 在老子的地盘，熊孩子要么挨收拾要么就滚回去
有爱心的人会有人爱 : 回复@大王_哈哈哈 的赞:你是日本人
一个吃干货的生活号 : 有完没完了 别惹我们男神生气[别烦我]
刘硕1992515 : 不行就干它
寒夏天SUMMER : 男神男神男神[笑cry]
九彩筋斗雲 : 出门左拐就是厕所，你该待地方在那边[doge]
ELLE_20_ : 别没完没了[doge]＿＿帅气的本命~王毅
我爱小汤碗 : 国民男神！！！赞赞赞 小日本不要闹事情了
37摄氏度女孩188 : 男神，顶你，霸气
肌肉兔子黄金果 : 新一代男神[鲜花]
鑫美画业杨建超 : 哎！小日本！
雪雪雪花飘 : 翻译过来就是……别给脸不要脸[偷乐]
孙玮是谁 : 小龙人好样的！
村头程师傅 : 回复@丑只是你没看习惯:还有王书记
哇欧佳音 : 小鬼子老老实实回家看你们的大片儿气吧 别给我们外长这找骂了 骂的你哭的叫妈 何必呢[哼]
诺雅方州 : 早该这样了，王毅部长，加油！
吱哇乱叫2 : GOOD JOB
瑞瑞瑞瑞V : 回复@我有一个仙女棒O:你想想谁看的多
Chronp : 王之蔑视@陈凯丽c @兔子与蛙 @梦萌Yue
骥鶛 : 回复@LJ-ZZOO:你有病(；一_一)
吴大大大大大松 : 不要没完没了[微笑]
偷影子的小太阳 : [中国]霸气！我替外长大人再翻译得通俗易懂一点，就是：日本，别TMD给脸不要脸[doge]。
怎么是王小小 : 收回韩国，日本，美国的大熊猫！！！
李明朗_ : 我们的外长[赞]
已經飛走YJ : [爱你]
瓜尔佳兰妍 : 这是最帅的隔壁老王哈哈
天黑烟火会完美 : 镜子不擦不亮，日本人不打不行
没名字怎么注册 : 要有办法反制才行，口头抗议无效。
鱼有一颗心唯有七秒的记忆 : 霸气
三观要像老干部 : 日本这种行为说白了就是事儿妈[微笑]
金燁_有戲 : 回复@向沐宸:快娶了他[doge]
潘梓彬 : 我男神霸气
有爱心的人会有人爱 : 回复@冷庭曦:[微笑]
凡神他妹妹 : 部长好帅
real_sooyyyyy : 我男神对日本表示对方已拒收你的消息
跟着我的节奏动次打次 : 好想知道日本怎么说的？
加油专升本 : 强大的中国[爱你]真好[爱心]
L-鲁肉肉L : 就是喜欢这么直接明了～男神帅[鼓掌][good][心]
冷庭曦 : 回复@有爱心的人会有人爱:就让它想吧，做梦是可以的[笑cry]
AsDapuvhRNN : 我们的外长[鲜花]
宋腾扭一扭 : 回复@LJ-ZZOO:可厉害了呢
妮子的美丽 : 老九门17/18 幻城第三集 赞俄秒发 免费！
-RMAYNWA : 我们的王外长就是霸气[贊][贊][贊]
蛋挞jun : 男神
陪着瑜洲一起慢慢走 : 王毅大大神之蔑视[哼]
好喜欢翡冷翠 : 感觉中国强大了真的很好[大哭][大哭]不用忍气吞声[大哭]
符哒哒哒 : 回复@GuuGB:让它们嘚瑟
张锦敏 : 国民新男神
刘恺___乐天风暴一派 : [good][good][good][强壮][强壮][强壮]
黑加仑爱鳗鱼饭团 : 你帅你说什么都对～
沫墨116 : [爱你]
_缺氧_13286 : 6666
裹在蜜糖里的蟲 : 帅！
小西红柿番茄 : 酷，霸气!
盾大叔 : 王毅外长其实也不舒服，内心特想揍他个小日本，但外交官代表国家，又不能那样，换成普通小老百姓，早上去干他了。
田淼呢 : 外长棒棒哒！
回幼儿园深造去ljm : 回复@荞荞又不胖:我也是！感动中…[泪]
萝莉星星小妞 : 英气侧漏！[拳头][拳头][拳头]
zyc-slh : 欢迎新网红[微笑]
慢热-小情绪 : 干他！
披着袈裟的老道 : 国内一有事就该日本人登场了
Minai-bie : 气场强大[色]
GuuGB : @符哒哒哒 霸气
我脸大我好看 : 我爸爸要揍你了
Yan同学_i君 : 男神男神[爱你]
观赏人生的路人甲 : 王之霸气
__Haylee : 爸爸的耐心是有限的  儿子你再闹  就要收复你了
Sophia小月儿 : 男神男神！！！！帅～
你麻痹一身仙女味 : 帅气的部长，哈哈哈
浪荡二十年 : 意思是 别特么狗叼耗子多管闲事了
happy少校-537 : 烦不烦？
种花家兔子momo : 男神干得漂亮～～
冬雪无阳 : 没完没了了
旁观者DM : 这届外交部长还行！
你是不是也姓chen : 王叔叔，请您开一个微博好么，我想和您认识一下[笑哈哈]
来杯心太软_ : 以后就多个菲律宾省 日本自治区[微笑]
Hey王沐木 : .
潘梓侠 : 别逼逼 钓鱼岛也是我们中国的[怒]
正华安保 : 小日本个龟孙儿
久黎hj : 回复@jane潇湘雨:王毅部长精通日语  还用翻译？[doge]
给认真放个假萌萌哒 : 哈哈，眼神犀利
那年的花泽类- : 王部长霸气
请不要粉我行不 : 我干爹真帅
用户5974784482 : 说的太棒啦！给王毅部长点赞[哈哈]
我只是单纯的漂亮而已 : 日本和美国有时候真是跟白痴一样，纠缠不休，都不想理他们了
丑只是你没看习惯 : 当代我只服王部长，
老葛建站 : 支持你，爱你么么哒
慕鹿1 : 男神了
薄荷艳阳天 : 表白男神，日本走开
Girl那时光依旧 : 帅哭了
大东子nice : 外长让你闭嘴你就闭嘴！
我就想改个名事真多 : 还特么有人要公示财产[挖鼻]眼界也就到这了
小小的路标向西 : 霸气
essence1996 : 爸爸的耐心快用完了，打你了可别哭鼻子@无知是无限的
-BB大王 : 这就是真正的大国形象[爱你]部长大大最威武[爱你]我大中国最威武[爱你]
回眸一笑---倾了谁的城41214 : 外交官真帅B-)
有爱心的人会有人爱 : 日本一直有想统治地球的想法
陈舒廷l : 请自己走[NO]
pH大于7 : 我男神好帅[害羞][害羞]
灬ZZX : 你囊个可以这么帅！把女孩子们都勾搭跑了以后连我这样的高富帅都取不了媳妇怎么办？？[笑cry][笑cry]
jane潇湘雨 : 翻译:关你屁事，还没完没了了？滚！
KhuntoriaFrost : 超级无敌的魅力[doge]
蔓越莓liny : [爱你][爱你][爱你]就是喜欢王毅大大这种语气这种态度
庆木公 : 小日本亡我之心不死
莆阳古意人 : 奉劝日本首相割蛋自宫吧，以后就不至于蛋疼了[酷][酷][酷]
吃土小队 : 回复@源氏物語110:ほんとうにあなたを残し、この台湾人爱どこどこへ行きましょう、あなたに不自由はない Leave the island, you have such a Taiwanese love where to go, not a lack of you 把台灣島留下，你們這種台灣人愛去哪去哪吧，不缺你一個
你猜我猜不猜呀呀呀222 : 王毅大大的眉眼好像周总理[爱你]最爱的两任外交部长[哆啦A梦花心]
沫沫沫沫小夏 : 一个大写的帅
元气阿潇 : 回复@Berry-be:你亲爸哭晕在厕所
圆圆谢ovo : 听说有些说日本很久以前是中国的领土[doge][doge]woc TMD就算是.也不会认尼玛这憋犊子的.日本鬼子阿东吧死去吧.!!!!!
这次换我讲故事 : 联想到菲律宾前几天想要恢复中菲对话以及日本前几日发表的批判菲律宾想要与中国合作的文章，是不是中国对菲律宾的响应并且明确的传达出一个信息就是日本是推手之一？毕竟合作远胜于对峙，我倒是觉得中菲关系会有缓和也说不定，比较看好这任菲总统
-小xinxin : 异常愤慨，强烈权责
陈滚滚滚滚滚 : 我就看看我男神 
艾希的忧伤 : 回复@西嘟咕i:他不缺
麦涯糖 : 王毅有周恩来的风范。
ROBORTXY : 诶，这不是男神吗？
咬一口甜甜的西瓜 : 奉劝日方不要活得太累[doge]
张小雷555 : 王之蔑视[爱你]
妹妹杨思琦 : 外交官霸气，为您骄傲
水蓝色记忆197414 : 你打我两下，我骂你两句。
柒小店 : 准备打遍环太平洋吗？
故事缺你xxx : 男神
大呆Ben出没 : 我可记得加拿大事件刚出来的时候好多人黑王毅部长呢，不知道那些人现在有没有啪啪啪打自己脸[doge][doge][doge]
sisi和boby : 一个字，帅！
随心06y : 就喜欢这样有个性的外交官，无视一切坚定立场，棒棒哒！[爱你][爱你][good][good]
夏日之风5683 :  5-
我就是大潘潘 : @潘猴子啦啦啦 我男神跟我老男神周恩来总理真的好像
赵雯51135 : 王之蔑视
圆圆的树 : 爸爸帅哭了[good][good][good]
June_614 : 王部长霸气侧露，展现着我国的威严，威风凛凛[good][good][good]
iwantto西柚wl : 日本你特么滚犊子
briefwu : 日本狗好烦人啊[怒骂]
柳树LYN下的蓝精灵 : 男神！！！！棒棒哒～～[爱你][爱你][爱你][爱你]
江春暮年 : 别给脸不要脸了[微笑]
晓洁姐姐啊 : 幺幺零吗，这个帅老头老是撩我[偷乐]
HDFZ2007 : 回复@Tick1:只能说明你孤陋寡闻了，日本的农产品畜牧品早就封杀了
新任菊花岛洞主 : 阳痿
Wooodie : 为王毅部长点赞[强]。不是你家的事 少tm的参和，老子不追究你给你面子，别给脸不要脸。
_____旻 : 打他们脸
心袁意满 : 有时候对日、美真的很无语，油抹布打不湿扭不干……
CoCo蔻Co : 对中国有功之臣，国家给他们再多报酬都不为过，他们代表的是国家，是国家的英雄，建议最低必须比中国明星酬劳高！！！
型者cc : 又能怎样
A龙玉龙 : 直接给他说管你求事。
Aki_73 : 放心了[眼泪]
dyww-HeIIen : 给男神点赞.好样的
一朵小2花 : 翻译一下就是 别给脸不要脸
家有两只小猴子 : 王之蔑视送给那什么熊:妈的智障！
你总是望着蓝蓝海面 : 说的好哈哈哈[开心]
连儿子休 : 日本的狼子野心从没变过，我不接受什么坏的是日本不是日本人这种理论，当然这是一个个概率，不是所有。侵华战争是铁一般的事实，不会忘不能忘也不敢忘。有人说历史已经过去，日本人能忘广岛之恨为什么我们不能？可他们是忘吗？他们是知道如果没老美做靠山，中国，南北朝随时都有可能动他们。[挖鼻]
黑夜的月亮_moonlight : 鬼子亡我之心不死，我们要给你沉重打击，一个卑劣的民族谁打他他怕谁，给了两颗原子弹乖乖给人家吐舌摇尾，没有能力自强拜托美国鬼子的控制，靠挑拨离间损耗美鬼实力，以此来换取自身束缚，这就是一个低等民族的做法！
爱做梦的南瓜姑娘 : 小日本这么嚣张，灭了你
木葉大喵_况 : 我记得当时大学时的国际经济法老师讲过一个案例，日本的录音机还是放映机质量特别好，美国需求量大，导致美国本国的产品销量惨不忍睹，然后美国做法就是把海关检查人员缩减到一人，人家按时上班按时下班，一个月检查通过量等于以前一天通过量[doge]所以这样的市场占有率瞬间降低。。。我觉得这个可以用
磨人的小妖精721 : 王大人霸气侧漏[赞]
太阳星星星星星 : 帅我一脸[爱你]
初心为洲的小米粥 : 霸气，就爱你这样
任柳青阿 : 国民男神
白七公子-- : 牛
赵嫣嫣然 : 手势解释:日方出门左转
一抹茶色的微夏 : 醉翁之意不在酒，一次次的乱搞，小心会出事的
梨花迷 : 男神！！！
致永远的大幂幂 : 脸比天大的岛国，我大天朝分分钟秒了你[doge]
无音信 : 帅炸！
衣布衣 : 日本回应：错了咋样？你能杂的？
西嘟咕_ : 部长 缺女儿吗 缺孙女吗我都可以[doge][doge]
miuMiuwaitme : 拍黄片出身的国家别没完没了！
Im黄婷 : [心]
li婷婷婷 : 在BB小心我削你哦
鹿寄我情 : 哈哈哈哈@我有一个仙女棒ovo:这个手势是：卖av的请别多管闲事[doge]
阳光佳佳 : 不知不觉成为王部长的迷妹[害羞]
NicolasPawn : 回复@梧桐叶落吾三生:不插手日本内政，哈哈
Sally-渝儿 : 只有我一个人会担心他的人身安全么～～[悲伤]
茜xi茜x : 即使与他国纠纷，也要坚持中国立场，做的好！老虎不发威当我们是病猫啊！中国忍气吞声这么多年是时候强势回归了！看评论有人说损失经济，呵，有本事你当外交官？你有威严吗？你有能力增加国家收入同时捍卫主权吗？中国有钱，这点浪费远比不上主权重要！看你大学生了还不懂吗？
杨园儿 : 中国雄起
段子手花再晨 : 没完没了的放屁，有没有点公德心，放屁可以离我远一点，我一生气怕你没机会放屁了！
不需要ID的微博 : 王毅部长[心]有颜值有才华的新晋国民男神！[爱你][爱你]
讨厌ON : 我宣布，他是我干爹[doge][doge][doge][doge]
狂放不羁要努力 : 男神！
za6za6 : 回复@源氏物語110:不过，谢谢你坦言。
是迷妹吖 : 王毅的迷妹上线[好喜欢]
阿里嘎多噶多噶多 : 回复@源氏物語110:所以你到底为什么要在这里用大陆的微博🌚井底之蛙乖乖回去吃茶叶蛋好么？
MoMo不敢艾特yzz : 拍AV的也是没完没了啦
超爱小鲜肉的汤七七-er : 男神！
-古月路笙 : 这气场[good]
AlphaHerculis : 不服滚出去.jpg[doge][doge][doge]
我是大牙宝 : 霸气外露！抽他丫的 [打脸][打脸][打脸]
蕴风曼言 : 没完没了这句好霸气！
CM么么嗒 : 厉害，喜欢
羊羊羊能宝 : 回复@杨田奥一郎:你们是真的中国人么？中国不打仗难道是为了保护日本人民不受战争影响么？
手机用户1815244344 : 男神好帅！[哈哈][哈哈][哈哈]
川人爱菜 : 说实话就我觉得部长表情太多！话说他们这个职位不应该是喜怒哀乐写在脸上的吗？
梓濛zzm : 帅气霸气的部长男神[good][爱你]
吴杨_无恙 : 非常赞同右边的看法，王男神，爱你哟[飞吻]@国民模范生:外交部长王毅，新晋全民男神[doge]
泥酱韩 : 回复@捉鸡逗逼:哈哈你牛
嗯哼晙 : 男神
用户5714509439 : 回复@LJ-ZZOO:财产属于隐私，关你什么事，你是不是想当公知啊。[微笑]
看见Galaxy : 有这个时间没完没了 不如去好好钻研一下怎么把风俗业推向世界[微笑]
阳光之里 : 回复@HDFZ2007:哈哈哈，曾经因为是某国畅销书想看来着，结果看了简介就像吃X，从未见过如此乱伦无耻之男主[崩溃][崩溃]
miayeah : 回复@LJ-ZZOO:出门咋不带脑子呢[可爱]
会飞的饭好哈哈哈哈哈哈 : 回复@LJ-ZZOO:你就是个傻
绝望的战斗龟 : 赞一个，为我们了不起的王外长！训得岛国的什么熊，就像老子训儿子一样。过瘾
Layssing : 霸气[good]态度就是要强硬[强]
安静的力量90212 : 男神
星俊贝添 : 小日本，不要一错再错，没完没了。滚，滚一边闭口好好待着。
用户5214687754 : 男神说的对。[拍照][拍照][拍照]
JUST_KR7 : 王外长霸气[作揖]
小美美菇凉 : 赞一个[good]
本命西皮有很多 : 可以，这很王毅！[赞]
小颗粒物 : 王外长！啥时候出视频！！！！！
楼下是傻B : 皇帝不急，太监急[doge]
天上飘着雨 : 回复@LJ-ZZOO:你先公示下名字先
ChouchouChoi : 男神[doge]
韩浩珊 : 他过国放个屁日本都要嗅一嗅的啦
紫罗兰oran : 我觉得外长大大已经很克制了，要我绝对忍不住骂他[doge]
兜兜空铛铛 : 可以 这很王毅[doge]
瑶瑶爱古风 : 发现现在粉王外长的人多了，各路黑子也出来了。
巴兰榭图书馆 : 王部长好霸气的说[good][good][good]
ELF黄二二 : 帅气，日本从以前一直这么表脸
库伯文 : 帅[doge]
学霸模式正在开启中请稍等 : 回复@麋鹿gained:你可以写简体字跟他对话[doge][doge]保证瞬间他文盲……
眉目上 : 帅！！！！！
啊呸ccm : 回复@末夕晴北北:对待怎样的人说怎样的话，那叫贴合实际。
茜xi茜x : 回复@源氏物語110:对，你不是中国人，中国容不下你这台独分子。所谓台湾人就是患臆想症整天搞独立的跳梁小丑。台湾自古以来是中国的。做你的白日梦吧！台湾早晚会回归大陆，现在希望能够和平解决，但若是武力解决你一定会挺身而出吧？可惜没有人会为你骄傲或悲伤。你不是中国人那就别用中国字别说中国语别登中国软件啊！
连红橙黄绿青蓝紫钻都没有的菲琳 : 不要一错再错，没完没了[微笑]
苦等李在元来成都的杨圈圈儿 : 可以的哈！很王毅！就是那么直白！不拐弯抹角[爱你][爱你]
紫罗兰oran : 只能坐实你们是别有企图哈哈哈哈，这话说的太有劲了
Sparkle-耐 : 感觉日本就像宫斗剧里的碧池、为达目的不择手段[doge][doge][doge]
za6za6 : 回复@源氏物語110:文化底蕴如此啊，你这么一说，我倒是理解了，为什么日本会敢做不敢认。
zhaoying21 : 霸气侧漏，我喜欢[doge]
摎杫 : 霸气[good]
-Zhaoyi- : 简单点一个字 滚 [哆啦A梦微笑]
姜yc- : 热门让部长公示财产的那个，内心是有够阴暗的[拜拜]是，公务员就是得艰苦朴素吃糠咽菜你才开心[可爱]这样谁还愿意当公务员？[可爱]
从前有颗秧苗 : @___Freya___ 蔑视 妈蛋卖黄碟的一天到晚插手别人家的事干嘛
兰之猗猗0127 : 就是这么霸气
李安娜 : 回复@青创社:[偷笑][偷笑][偷笑]
Gordsaer : 回复@源氏物語110:字数有限，贱人就是矫情
国际流氓贸易 : 我都快吃不起到啦
过场多7-7 : 回复@向沐宸:娶你能睡么？[笑cry][笑cry][笑cry]
不是每一滴丙泊酚都叫张小麻 : 毅神说话不严谨啊，应该是告诫日方“不要一错再错没完没了臭不要脸”。
皮蛋蛋呐个球呐 : ！怎么这么帅
魔术师Jiang : [微笑]听到了吗
HDFZ2007 : 回复@阳光之里:源氏物语就是小日本的乱伦史，还是可以看看滴[开心]
secretrunning : 论一个高智商高情商外交部长的理论修养
冰沁333 : [赞]@老马征途-: [威武][威武][威武]
白领的领子也会黑 : 对给脸不要的小婊砸，就得这么对待。
likeualot : 回复@LJ-ZZOO:你是zz吗？
洗衣机很努力1314 : 回复@源氏物語110:能不能别用我们中国的汉字，这不是打你自己脸
魔女茜x : 霸气
盘先生-阿里巴巴授权小二 : 阿里巴巴诚信通全面升级，打通全网多平台发展，开辟了新纪元的诞生。真正实现让诚信看得见，让诚信变财富，让天下没有难做的生意。你还在考虑什么，赶快加入我们吧。13064560540[心][心
末夕晴北北 : 回复@啊呸ccm:[笑cry][笑cry]，我嘴有点损哈，嘲讽力max[嘻嘻][嘻嘻]
羊羊羊能宝 : 回复@源氏物語110:台湾没有坏人么？[微笑]
花与灼眼丶 : 在没完没了，我们反手就是一巴掌。[哆啦A梦微笑]
彼此60 : 我男神~帅爆了~~~[嘻嘻]
盘先生-阿里巴巴授权小二 : 阿里巴巴诚信通全面升级，打通全网多平台发展，开辟了新纪元的诞生。真正实现让诚信看得见，让诚信变财富，让天下没有难做的生意。你还在考虑什么，赶快加入我们吧。13064560540 [心]
青创社 : 回复@李安娜:[good][good][good][笑cry][笑cry][笑cry]
末夕晴北北 : 回复@薇薇levanda:脑残一个，被骂两句哪凉快哪待着得了，搁这bb没完的，不还回去感觉没他有理似的，迷之自信因为知道的少呗井底之蛙说的就是这种人，湾湾要都是这种少年吃枣药丸呐[笑cry][笑cry]
Lee_Annly大江 : 王大大：你不要搞事情哈[doge]
阿丹呐_ : [doge]
赵盈莹Cz : 哈哈哈哈，就喜欢男神这个态度[偷笑]
小眼弯 : 霸气！
-Seua : 霸气[doge]
兔子团长正在待命 : prprpr
只恨我生汝未生- : 就喜欢这么霸气的领导人！
光子努那 : 我的天呢王外长帅的一塌糊涂！！！[心][心][心][心]
3D酷字在线DIY : 看帅哥装的成份较大，肯德基门口拉横幅大妈一家的
原来叫雅文 : 警惕日方不要让政治错误拖累经济下行(●°u°●)​ 」
yangli1874 : 就说我们大大帅不帅，就说我头像上的那个帅不帅
爱吃草莓的白丸子 : 我喜欢王叔叔[good][good][不好意思][不好意思][good][good]
beautityzcm : 男神[强]
红酒人生志强 : 说得都到位了
一笑嫣然2008 : 外长棒棒哒[爱你][爱你][爱你][爱你]，就应该这样对小日本
SimplyNi妮 : 霸气，[赞][赞]
阳光之里 : 回复@源氏物語110:你一日本人还好意思在这搅浑水，另:以后不要用源氏物语装逼好吧，容易遭雷劈~~（凡是中国人都受不了那三观）[hold住][hold住][hold住]请自行Google源氏物语
没关系啊是我啊 : 外长大大要不要考虑搞个粉丝见面会[doge]
红酒人生志强 : 说得好
红酒人生志强 : 好
za6za6 : 回复@源氏物語110:350茶叶蛋智商，聊下《源氏物语》，听说它影响了你们一千多年的文化，已经根深蒂固了。你们的Av业，如此发达，是不是崇拜《源氏物语》的结果。
自由现金刘 : 南海暂时消停，还是要主动在东海给予日本压力。南海对日本不疼不痒，闹腾对日本有百利无一害。东海才是日本软肋，尤其要直指琉球！
庆恩_Daisy : 男神出现了
女医明妃传-小贤贤的心肝 : [good][good][good]男神
许小许xl : [威武]87！
阿柒-Sunny : 眼神好犀利[耶][耶][耶]棒棒哒
陌若安生TJY : 这才是真真的男神，真不知道那些追韩国棒子的脑残粉是怎么想的。
源氏物語110 : 回复@Gordsaer:留言有字數限制，還要我跟你矯情?
杯子里的小森林 : [强]
SYLVANAS---WINDRUNNER : 日本你们做人不要太菲律宾
还不给本宫跪下 : 日本是出来卖萌的么！再二下去，药丸啊……
大明洪武正韵 : 王部长的面相像道观壁画上的天神！
可樂没法喝 : 回复@LJ-ZZOO:这样有意思？？？他在维护国家的利益 你要闹啥子窝里反？？？你能耐你去
南屏晚钟点工 : 小日本叫爸爸
Cheer莎菲娜 : 没完没了可还行 中国对外第一颜王部[心]
贾少轩66 : 赞！
ziweixing11605 : 我也叫王译，以后也是外交官
pimiqiu : 王之蔑视
臭脾气小妞ei : 日本小鬼别给脸不要脸
快叫我王子哥哥 : 我爸爸有点帅
甜懵栗 : 喜欢部长的没完没了
我叫印小山 : 再给中国十年时间，让他们都不敢惹！
啊呸ccm : 回复@末夕晴北北:[赞][赞][赞][赞][赞]说得好！
丶美美的你 : @丶小小的你 男神
李安娜 : 一个盛产女优的国家还想和一个盛产女汉子的国家作对，真是不自量力哈哈
陳不沉落 : @方圆小里-
想剪短发的长发欧巴 : 这很王毅[爱你]
Miss淼喵喵 : 小鬼子听见没有啊 别没完没了啊 爸爸没空看你们耍
衬衫的价格是九磅十五便士_ : 虽然我很喜欢日漫，但我觉得日本政府是个表字[doge]日本政府里所有人都是[狗]酿养的[doge]
IMLAYS : 男神啊帅一脸
想剪短发的长发欧巴 : 男神赞个
荷搪居士 : 对牛弹琴，牛不入耳！
pcy_Embrace : 回复@Flora_HYDIEL:嘿嘿嘿[噢耶]
柠檬味吴世勋 : 日本真是心比天高[拜拜][拜拜][拜拜][拜拜][微笑][微笑][微笑]原地爆炸最好[微笑]
閒人一止 : 一個外交部發言人不成氣候，關鍵是頂層設計！小日本的思維還停留在二戰時期，我大中華早已經“國富民強”，三聚氰胺都毒不死的新一代，以迅雷不及掩耳之勢滅了日本就一瞬間的事情！
四叶草周文海 : 这是日本想借南海问题，来解禁集体自卫权，对中国进行挑衅，严重影响国际次序，要求对日本发出警告，不然有可能会发生战争的可能
GentlegirlLee : 爸爸生气了[doge]
米老鼠琪minimini : 看我们王叔叔这如关二爷般一身正气的脸，我心里就妥妥的安全感，信任优秀的外交官们，信任国家，中国，一点都不能少[haha][威武][威武]（ps:还和我是本家姓耶~~）
薇薇levanda : 回复@源氏物語110:你眼瞎还是脑子有问题，稀罕台湾，我大陆大好风光会稀罕你那个破地[吐][吐][吐][吐]
Qiuyinhahaha : 哈哈 没完没了 王外长帅气[羞嗒嗒][羞嗒嗒][羞嗒嗒]
啊呸ccm : 回复@源氏物語110:台独gun，团成个球离开我们的视线。
夕莫兮离 : 王毅部长是继周恩来总理后我另一位男神[爱你]
用户3739209282 : 为了不给后代留祸患，建议灭了琉球岛，
大名月 : 回复@Berry-be:哈哈哈
我的微博名字并不长啊 : 就喜欢这严肃的男神样！[doge]
北尧少年 : 看到外长这么帅我也就放心了[doge]
Danger前方高能预警 : 小日本，是不是给你脸了[微笑]没完没了了还，自己是个什么东西不知道啊？
他的蓝星 : 外交部长也是霸气
锥子韩网播报站 : 没完没了 这个词语我喜欢[坏笑]
赵小清要成为赵老师 : [赞][赞]
末夕晴北北 : 回复@源氏物語110:还是那句话你这不是找骂嘛，赶紧找你的团队去找你的美国爸爸去，跑到我们这里bb没完了，你都不是中国人打什么汉字啊，没听过一句话嘛对待敌人要秋风扫落叶般无情，对待你这种看不起我的人难道我还要笑脸相迎不反手一个地雷就不错的，臭名昭著？孩子你是生活在上个世纪吧赶紧去看看医生兴许还有治。
鎏-Jade小玉儿 : 微博名为“ 源氏物语101“的湾湾朋友需要大家的“祝福“！大家可以和他切磋切磋！[doge]
Gordsaer : 回复@源氏物語110:说出这种话的，通常没什么教养[吃惊]
Sunny珊珊033 : 霸气
君NC-J : 回复@梦想阳光123:你倒是有脸在这里BB？别以为你会打中文别人就不知道你是小日本的狗腿子！真是欠喷
helloBart : 日本可能真的以为自己是美国了 或者真的以为关键时刻美国会帮他[哆啦A梦汗]
周凤j : 不要一错再错这话说得好
用户3739209282 : 人民需要这样的领导，中国需要这样的声音，很激动
懵蟹菦寶Karry王 : 男神[心]
南宫残阳123 : 王毅：你们小日本也只有拍A片的份
薇薇levanda : 回复@末夕晴北北:别搭理这种人了，谜之优越感，真以为地球没了他就不转了，对美国喜欢卑躬屈膝的人，怎么指望他能直起腰！！！
崔崔CYJ : 王部长威武
与速哥同在 : 南海地区从古到今一直是中国的领海，这一事实不是美帝，菲，日等说改变就能改变的。我们不惹事，但也不怕事。我们捍卫国家主权和领海完整的决心从未改变。
婷哥哥 : @爱啃梨的书宇啊 @以希儿 外交部长
爱音乐的都是好孩子哦 : 他好帅！我是男的！！
十八君是个什么菌 : 不要 没完 没了 懂？[微笑]
快乐晓晴 : 部长霸气[威武]
酱油梅子飘过 : 画风好像变了，现在说话强硬些了
月老下次请给我和王俊凯系死结 : 你好帅啊[转发]
Noel小爱 : 男神啊！老子一个大老爷们都犯“花痴”了
Yekha : 大写的帅！
沧海火线姐 : 外长语气强硬 国家强硬 人民就不用崇洋了
我爱哆啦A梦蓝胖子 : @蓝色湖水blue 我再也没有办法直视他了[笑cry][笑cry][笑cry]
BMWNiki : 不要没完没了
木木马__ : 王毅爸爸好帅[心]
Jauar : 就还差一句就拿骂粗口了估计[doge][doge]
喜欢飞的猪2014 : 这才是真正的帅！！！
果瓤儿 : 没玩没了的谴责，警告！说多了水都烦了！
打怪君 : 男神好帅[害羞]
郑帝元- : 真他妈帅[心]
凡尘点点09 : 回复@LJ-ZZOO:那你干嘛要隐姓埋名啊，怕什么
Super_luckyR : 帅呆了，浓眉大眼有情有意有智慧。
梦中的幸福3122961200 : 大赞[强]
柔弱滴女汉纸就是偶 : 一个靠av发展的国家找什么存在感…
超级的污力薛太太_ : 王大大威武[思考]
我爱的人679 : 帅气
sunsweet君儿 : 必须男神，全民偶像，全民男神！[赞][赞][赞][赞][赞][赞][赞][赞][赞][赞]
慕喬若曦 : 流氓一个
源氏物語110 : 回复@薇薇levanda:看起來中國遊客蠻稀罕台灣的~怎麼辦?跟你講的不一樣耶!
汤佳睿同学super : 大家记住了，日本永远都在等着把中国灭掉的机会！[怒]
Karrychenckl : 我也单方面宣布王毅是我干爹。 [耶][耶][耶]
每时每分每秒1212 : 这才是男神
栗子Cherish- : @是李念呀
阳光甚好ing : 帅爆了[爱你]
杜丹的杜杜丹的丹 : 喜欢这样的中国，喜欢这样的王大大[爱你][爱你]
弥尔_ : 弱弱的说一句。我也叫王毅[doge]
O_o柠檬不酸o_O : 王毅真是中国外交官的最佳人选，柔中有刚。就应该硬气点，毕竟重超13亿人口大国
凡尘点点09 : 回复@LJ-ZZOO:智障
云在天晴前 : 外长真是酷炫，霸气，日本[哼]脸皮厚的可以，钓鱼岛争端还没解决，还插手闲事[哼]
雅婷-小北 : “没完没了”这句话好帅啊[色][色][色]
张家小西西_ : 这么一来我也想宣布了[喵喵]@捉鸡逗逼:我单方面宣布王外长是我干爹[doge]
末夕晴北北 : 回复@源氏物語110:少年啊一看就是没工作的孩子呢，等自己赚钱再说吧，过两年就能感受到你们湾湾经济倒退的危害了，现在你们湾湾已经没有竞争优势了话别说的太早哦，到时候可别求爷爷告奶奶的。不光是大陆游客是游客普遍降低，看来不光是我们讨厌你们啊这个人呐不能有了奶就忘娘吃里扒外这事太狗可不能做啊。
LittleMonkey丫 : 2016最佳新晋男神[拍照]
Cloverstar0806 : 王大大霸气！[good][good][good]
无风无雨年复年啊 : 男神！！
王小萌你是我的光 : 霸气！
星语幺儿 : 日本这么爱凑热闹！
自是思量渠不与-人间总被思量误 : 回复@源氏物語110:不要在这逞口舌之快，滚远一点，台湾咋这么多弱智！
四蹄_咩咩怪 : 国家实力强盛了，我们的外交才能使用强硬的立场与态度！[赞啊][赞啊][赞啊][赞啊][赞啊]
南数秋港 : 我王外长最近忙死[微笑]
鎏-Jade小玉儿 : 日本怎么那么闲啊，天天管我们的家事，跟你半毛钱关系没有！然而还有几位湾湾人民来微博找存在感！
两只画布小马 : 外长好帅，我是迷妹[噢耶]
寂寞似清福 : 能死小日本，吊个鸡毛
chen玥r : 意思就是不干你的事，别瞎bb！  再bb!老子揍你[挖鼻][嘻嘻][嘻嘻]
幸福的鱼19 : 外长好帅！
梦想阳光123 : 名为奉劝，实际是威胁。今天的出来的东盟南海宣言，不允许武力威胁，不允许填海造岛礁，不允许在无人岛建生活设施，不允许在无人岛居住，条条针对的是中国，还有脸说日本一错再错
za6za6 : 回复@源氏物語110:谁说的我不知道，但我知道你信了，还一个蛋卖了350。350的茶叶蛋智商，我发现这个名字比较符合你们的智商，350，绝对人类最高智商。
金希澈你是谁我不认识 : 再嘚瑟把你黄盘摊给砸了
阿墨喵_每天都在等鱼幺更新 : 实力圈粉，舔舔
_旧梦多故人_ : 回复@源氏物語110:是的，我们中国人一人踩一脚，台湾就沉没了。当然，台湾之所以没沉没，是因为，台湾是中国的一个群省
王大小姐oo : 龟儿子 个人爬开
哆瑞咪发嗦啦西_Candy : 可以 这很中国[心]
我有香烟我有故事 : 帅气！ 这tm才是男神！ 比你们所谓的小鲜肉强多了！
在路上whong : 越来越觉得迟早会有一海战！
糖醋里脊圆又圆i : 能不要拿这件事烦爸爸，爸爸很忙，不要逼我
彭琳YOY : 偶的男神太帅了[噢耶][噢耶][噢耶]
薇薇levanda : 回复@源氏物語110:你当真以为我们稀罕去台湾，别自视甚高好不好！！！！
与时光同眠窝 : 敌人是站错立场的朋友
焱儿Believe : 这态度，我喜欢[赞]
ibommm : 劝你不要太菲律宾
Tick1 : 回复@易瓶冰红茶:没看到制裁，只知道一直都在谴责，到今天突然就变成男神了，水军的力量很伟大？还是因为看脸？
一了月月鸟 : 要来硬的。
两全ET : [心][good][good]
假蒜蒜_garlic : 王部长永远的男神[花痴][花痴][花痴]帅爆了！
源氏物語110 : 回复@末夕晴北北:別人怎麼問，我就怎麼答阿~而且中國遊客惡名昭彰也不是只有在台灣才這樣，全世界都有目共睹~
迷人的胜利cvip : 中国是崇尚和平的国家，能和气解决的就和气，因为我们经历过太多战争跟不安宁，和平对这个国家太重要，但，你真的惹急了中国，分分钟完爆你，管你是个什么叼！飞机大炮打你个岛还不是问题！no作no死
青稚_k : 熟悉的脸庞
王大大_98 : 给你脸，你还没完没了了[doge]真讨厌，给你一个眼神自己体会[doge][doge]
情癫大圣sss : 超有气质
L1314151224 : 中国的地盘，还是就给我们自己沙耶
cactus仙人掌小盆友 : 男神
UP-TK : 屠美灭日 指日可待
Jay是胡蕾蕾的男神 : ！屌
露露不是六个核桃 : 这个外长太霸气。赞
鹿五爷与吴七爷 : 男神霸气。
蚂蚁借呗帮开99 : 蚂蚁借贝帮开找我
乡农香侬 : 字幕∶再bb没收你光盘
慧努力的娟子 : 给它个白眼
硬漢-lz : 男神
菜菜菜爱吃菜菜菜 : 男神呐
源氏物語110 : 回复@末夕晴北北:這樣阿?我還希望再把中國遊客的人數降低呢~~~現在台灣旅遊勝地已經沒這麼多中國遊客了，終於還給台灣一點清淨與乾淨，這才是好的旅遊品質~
消小弭 : 男神
末夕晴北北 : 回复@源氏物語110:哦，前面的好多没翻到说我们自卑说我们卑躬屈膝说我们意淫，你们就自信你们就受人尊敬。你可以有这个想法不济自己发个微博朋友圈什么的跑我们这底下评论个什么劲啊这不傻了嘛，你都骂我们了我们不回骂回去就怪了。
算命先生给起的好名 : 外长是我爱豆
M温言M : 已经帅出天际，这风范[威武]
_只愿肩上花一朵 : 单方面宣布此外长大人是我男神[害羞]
C萝卜大棒 : 回复@意大利足球新闻:是老总换了。
大力王1113 : [思考]这也可以？我方提出严正抗议和强烈谴责[白眼][白眼]@捉鸡逗逼:我单方面宣布王外长是我干爹[doge]
大飞_00 : 为什么叫小日本，因为它是永远长不大的孩子，它只会一错再错，没完没了
著名神经病Eason : 爸爸说的最有道理
Rainbow_逸琪儿 : 王蜀黍霸气外露[拍照][给力][给力]
瑶妹先撤 : 帅
源氏物語110 : 回复@za6za6:人民幣跟台幣的50比1可不是我講的，你怎不去念你那些智商高的中國網友?
leonautic : 奉劝日本人，你中国爷爷生气了迟早要揍你。
西北还向北 : →_→@再见瑞卡巴卡再见：王的蔑视[右哼哼][右哼哼][右哼哼]
听风者SHF : 现在看到王毅的名字就激动[哈哈]
易瓶冰红茶 : 回复@Tick1:谴责的背后是制裁，请你也关注关注背后吧！外交部发言人是一个国家对外沟通的桥梁，你见那个人打架用牙咬的。
rita-jay : 一错再错，没完没了！哈哈哈！
再见以前再见雨天 : 看到男神我就放心了
我也是总攻DTX : 霸气!
杨田奥一郎 : [浪]@乌鸦树映画:从钓鱼岛  就一直强烈谴责日方。奉劝日方不要在这样了。然后。。。。。。。。。知道今天，不晓得日方耳朵有木有出老茧
Ken大卫 : 日本将沉没
Jchan_Y : [爱你]
雪哒班 : 真帅！棒棒哒！！
_DaisyDream : 卖毛片的出去[手掌]
桼秊 : 偶像
陌妄vae : 啊啊啊啊，我男神帅死了
李玄蚊孓1 : 国家战略一切都是以大局为重，等有天富起来了，我相信国家不会是这样让人欺负了，到时候再打狗，打猴，，，
李大榔头 : 真帅
儒儒202 : 霸气
yang光闪铄 : 男神！
王外长的小迷妹 : 前排挤挤，表白外长[爱你]
Ken大卫 : 日本沉没！
Jessica小E : 就是说“不要登鼻子上脸”
Call玲小姐 : 简直不要太帅[耶]
曾益lucky : 中国新男神！
viiiickyyyy : 给脸不要脸的小日本[微笑]
winni小可 : 外交部天团王团长就是霸气。支持
加拿大學習粉絲群 : 王部长对日本发出第400次严重抗议[good][good][good]
YI--恋 : 很明显的在说滚边个子去
Stp-GD : 赞。
za6za6 : 回复@源氏物語110:你的350的茶叶蛋智商，我是领教了。说说你的种族优越感吧，先从你的名字@源氏物語110 讲讲你的祖先的乱伦史《源氏物语》吧。
Stp-GD : 回复@意大利足球新闻:陈毅说过只要中国强大了，我们在外交上才能挺起身板。
金大毛布什他娘 : 这果断就是男神！
斯利客 : 不不知为什么还要和他会谈！
伴你dao永远 : 灭了小日本TMD
嘿啾s : 那个让王毅部长公示财产的简直傻屌，还带着一百多个傻屌
WYIJIN哈 : 王毅外交部长的迷妹。真的很帅，有责任！有担当！ps 眉宇之间的杀气啊[色]
铛铛滴叮叮 : 大气！！霸气！！解气！！
他权了志龍 : “卖盘的滚出去！”
励志追到一枚兵哥哥 : 真男神
幸福的小羊羊的天空 : 意思再乱说话 烀你
李岚风清 : 这一波波的，不能停阿，，[哈哈]
Hot_Zeng : #新店开张#复制这条信息，打开[向右]手机淘宝 [向左]即可看到【C创意库】￥AAGywQea￥
默默地喜欢着 : 如果有一天我能成为外交官为国家发声，我一定会很自豪的。
梁芯芯尊纶 : @Leeminho敏敏敏敏敏敏 @李李李大莎
AYST小飞鸟 : 日本[日本]你妹的，你把你祖宗拉出来问问当面老毛是怎么弄死他的！现在弄你那就更简单了！
酒量已然任人欺 : @日本国驻华大使馆 听到没，打个电话回去说一声，别没完没了的，烦不烦
末夕晴北北 : 回复@源氏物語110:吆喝，那我这天天在新闻上看你们湾湾一个劲的求我们大陆过去旅游，少年真是迷之自信啊，你去外国旅游是在胸前挂个牌说我是台湾人了嘛人家是看你说汉语再说国际上承认台湾是中国的那是给中国面子懂否？还是太天真先出来见见世面再说吧[doge][doge]
如假包换闫vv : 我王某人劝你最好谨言慎行
Chen-Jiaa : 部长大人[威武]
peach001 : 外长在外面老提议对话，人都拒绝了
Tick1 : 天天就是谴责，怎么到了今天成男神了？自娱自乐的那叫单口相声好吗？相声演员王一？
地三鲜炒酸奶 : 表白我男神，真是太帅了
Haileymelon : 新晋男神，不行我得转一个[心][心][心]
biu丨biu_98708 : 我们的外交部长真的是霸气
SHENGSIYU : 中国真的缺这样的领导人
尼泊尔少女 : 回复@LJ-ZZOO:为什么你这么不要脸？
-HONDA-阿乐 : 部长风范
鸡毛蒜皮2001 : 对这种流氓国，不跟它说，太扰人就扁它。
kill-yfl : 回复@LJ-ZZOO:人家有隐私权吧
Lee暁Y : 龟儿哈鸡儿日本鬼子，，批岛国祝你早日被淹[微笑]  你们国家女的都是活在马赛克里头的[打脸][打脸]
零点林中飞雪 : 说的好！
可可没有慕斯 : 热评那个也公示一下你的财产吧[微笑]吃屎长大的脑残[打脸]
乌鸦树映画 : 回复@我是一算瓣:就是  只会谅解谴责，然后强烈谴责，和强烈谴责。
养只温柔的兔子 : 对于评论里说不来实际的光嘴上说说有什么意思的人 要不你先参个军表示一下？
宗霖呀 : 直接对他说没你事 少逼逼就可以了哈哈哈
想得美的背带小主耶耶耶 : 霸气[爱你][爱你][爱你]
涵森欣 : 霸气
睡眠不足兆 : 没完没了，霸气[doge]
棱蒙之 : 政冷经热模式循环中……
hzhong2007 : 日本就是欺软怕硬的国家
王外长的小迷妹 : 前排挤挤，表白外长！[爱你]
ichiko_blbl : 男神就是说什么都对[爱你]
甘洒热血沃中华 : 让我们团结起来，团结在中国共产党的周围，认真工作，早日实现中华民族的伟大复兴。历史和现实都无可争辩的告诉我们：落后就要挨打！
丢丢没sei了 : 门在那边 出去[微笑]
不爱将军爱相柳 : 是我粑粑
魏都雨人 : [拍照][围观][威武]
souththxxxmino : 太帅了[心]
秦天的塩対応 : 哎，外长看起来憔悴了，最近国际都不消停
可笑绅士 : 帅
车车瑶NAMLuLu : 就是就是[右哼哼]
-何玉琳hyl : 点赞 国人支持到底
乌鸦树映画 : 从钓鱼岛  就一直强烈谴责日方。奉劝日方不要在这样了。然后。。。。。。。。。知道今天，不晓得日方耳朵有木有出老茧
中华联合省合众国总统办公室顾问 : 回复@Adepa:我说了这么多，你会去看，还要证据，加拿大暂停了跟中国贸易协定的签订，不是证据？
不会飞的鹅鹅 : 只有中国强大了我们说话才会越来越硬气～[good]
子曰DQ : 给日本来点狠的，管的闲事太多了吧
ZBiYu : 帅
胖了个胖Bruce : 回复@LJ-ZZOO:看你说的这么正义，要不你公示一下你的财产？
sssunshinessssunny : [爱你]
秋风悦你 : 别没完没了了！
toumunuo : 回复@LJ-ZZOO:什么屌东西！滚！
525Cinderella : 男神说什么都有道理[害羞]
思者无形 : 小心把小日本吓死了[吃惊]
喵喵的小裤衩 : 天天光说有什么用，没点实际措施，难道是打嘴仗来的？呵呵
追风少年徐大拿 : 回复@孙喵喵还是孙猫猫:大妈不跳广场舞能干嘛
在我眉梢 : 听到了没有，不要没完没了[拜拜][拜拜]
阿阿阿恒Hengography : 回复@源氏物語110:我尊重你发言的权利，但是别带偏见。哦，对了，记得回去说一下，茶叶蛋是吃得起的。[doge]
小哇ForeverAndAlways : 一直都觉得王毅很帅！讲话也很给力！[good]
杨哥是我男神 : 俨然成为新一代网红！
柠檬酸没有邹小邹 : 神经病啊，没完没了，中国祖宗表示快受不了你们了你们自己小心点
Tictok-wow : 王的蔑视！！
小七姐姐姐 : 理他都是给他脸
Susan_Muzi : 是该给小日本点颜色看看了
AA12全自动散弹枪 : 中国外交语言普及，我们的忍耐是有限度的，还有勿谓言之不预也，说白了就是我要揍你了[doge][doge][doge]
麋鹿gained : 回复@郑阿璐:估计脑子给屎搅了
7MCHANG : 我单方面宣布王外长是我男神[心]
M麋鹿777 : 就喜欢这么直白[doge][鲜花]
Alone一Alone : 新晋男神[笑cry]
mmmmmmmmmmli : 男神男神~[哆啦A梦微笑]
甘洒热血沃中华 : 还是那句老话：中国人不是被吓大了！
阿忞-- : 中国就需要您这种不卑不亢，挺直腰杆为民族说话的人。[拳头]
末夕晴北北 : 回复@源氏物語110:你跑我们大陆还是人民日报官博下面说这些话不是找骂嘛，sb了不是，脑子是个好东西希望你有[微笑][微笑]，还有不是中国人请不要用汉字来交流用你美国爸爸的语言呗[微笑][微笑]
小锁匠眼镜上的防滑绳 : 看成 应 约会 见日本外相[笑cry]
学习中取乐 : 都起开！！！！这是我的干爹！我的！我的！我的！都别抢[哈哈][哈哈]
我是一算瓣 : 就会吵吵，真不知道这种节目是给外国人看，得还是给中国人看得。钓鱼岛，远东，收不回来，南海又出事！真憋屈啊。
甘洒热血沃中华 : 为我们的胜利喝彩吧！同胞们！
自在小番茄 : 不怒自威[good][good][good][good][赞][赞][赞]
攒钱买-摩托 : 也是，一个臭溜缝的。
Permitted萬事 : 食肉者鄙，未能远谋！该换换人了[微笑]
十七只小鹿仙儿 : 厚帅[抢到啦]
其实我也不知道等啊等 : 我王叔果然大不同[哈哈][爱你]
小亚妹儿要减肥 : 霸气威武
Adepa : 回复@中华联合省合众国总统办公室顾问:不知道你哪里来的脸说自己爱国。公知就公知，大方承认倒还觉得你是个人。王毅损害中国利益？你有证据吗？就可劲的抹黑吧，我看你个渣滓能有什么作为。
凡繁烦饭番茄 : 天天奉劝有个卵用
倔猴爱上幽默羊 : 小鬼子就是堆臭狗屎
郑阿璐 : 回复@麋鹿gained:多半有病
toumunuo : 霸气嘞！嘛时候你直接给小日本一个大耳巴子，我天天给你烧香[思考][思考][思考]
Flora_HYDIEL : @pcy_Embrace 男神就是帅
怪瘦很酷- : 招兼职 适合在家的宝妈 学生 女性朋友 会玩手机就行 主要做客服 工作8小时 底薪4000 有兴趣可以加微信了解：Apeixuan-
甘洒热血沃中华 : 美国的克里宣布对南海仲裁不持立场！
郑阿璐 : 回复@为你声沙好吗:我看也是
孩儿他爸5601561547 : 团长霸气
kiss_sam昊昊 : @中国国际救援队: @人民日报:【人民微评：对话远胜对抗】选择对话而不是对抗，维护和平而不是制造分裂，中国东盟联合声明不提南海仲裁，传递出积极信号。那些选边站队的国家没有得逞，那些别有所图的国家该靠边站了。中国东盟本是命运共同体，即便有分歧，也完全可以通过谈判解决，将南海建设成为
天天开心游泳 : 直接开战
郭子凡的小衣柜 : 不要没完没了！
小小氮硫碳 : 偶像  偶像  偶像   外长[威武][威武][威武][威武][威武]
天天开心游泳 : 。
小四季豆儿儿儿儿 : 还没完没了了还，咋不去死，
阿阿阿恒Hengography : 回复@中华联合省合众国总统办公室顾问:新闻自由，在中国就是谣言的温床。美国黑人警察被狙杀的时候还不是封锁新闻报道。孟德斯鸠说过，民主制的前提是人民有美德，看看微博就知道根本没办法民主。更何况，哪有真的民主？
_贤阿爸的小跟班 : 看到男神就点进来了
没有故事也没有酒的女童_ : 超级帅！！！
721万福 : 王部长，真为中国人涨脸[赞][赞][赞][赞][赞][赞]
为你声沙好吗 : 回复@郑阿璐:不，他只是出生时忘了带脑子[微笑]
何可啊何可 : 意思就是没你JB毛事，你就别瞎BB。。。[doge]
Azalea-Cri : 就是！唧唧歪歪的跟蚊子一样！[怒]
起个名字一点儿也不简单啊 : 我大天朝的外交越来越直白，越来越霸气，好喜欢[眼泪]
用户5722999287 : 祖国有这样的外交真长脸！[心]  太霸气了 分分钟干掉小日本
洛一枳 : 男神一脸鄙视日美的表情
意想不到的动听 : 不要一错再错，没完没了！
张煊 : [doge]我是粉丝团我骄傲
丨五空 : 我是中国人  。不断强大的中国人。
Adepa : 回复@中华联合省合众国总统办公室顾问:啧啧啧。你哪里看到中国不民主自由的？如果不自由就没有你这种智障在这里发表言论啦。世界上有种东西叫国情不同你知不知道？一味的跪舔民主，中国13亿人口，国土面积这么大，你来个民主投票给我看看呗？
没有人懂 : 男神
小哼哼哈嘿 : 我觉得不需要跟它多说话，直接揍它顿它就长记性了[微笑]
杨妮0322 : 一见外长误终身吖
冰若心Cynthia : 霸气[酷]
末夕晴北北 : 回复@源氏物語110:那跑我们大陆微博下面评论个毛线不要太ky好吧，就像日本一个劲掺合我们中国南海的事一个性质，没完没了的，哪凉快哪待着去我们也没人请你过来啊再说这里也不欢迎你找你志同道合的人去想怎么bb怎么bb，慢走您那不送小心别摔着[微笑][微笑]
我还是砖家 : 不用劝；可直接搞他；让他自己感到得不偿失；日本是听得动劝的吗？
逝去的青春851223 : 老子二十年前就听过这句话了，再过100年都还是这句话！麻痹的
易只呆头鹤 : 帅帅帅[赞]
麋鹿gained : 回复@郑阿璐:负责来搞笑的
世界上有好多太阳3A87 : 这个手势——早晚给你小日本收了，给老子当厕所[拜拜]
一只放空的猫猫 : 从内心感到骄傲
沐沐866 : 回复@麋鹿gained:这个台独可能受刺激了，要么就是智商感人，来找骂来了。还有一种可能就是他本身是大陆人想红而已，自我炒作
静曦曦S : 小日本找死么一天天的，不作就不会死的很惨[怒]
扶摇直上九万鲤 : 后一句是:滚犊子[喵喵]
咕咚咕咚咕咕咚咚 : 没完没了[喵喵][喵喵][喵喵]
剑剑惹人爱 : 好厉害！棒棒的
Attitudelife7 : 小日本不要一错再错，没完没了！
韩喜儿 : 外表柔和 话语刚强 为我们的部长点赞
硄硄就是劉小光 : 王毅外长出手必能镇得住小日本的嚣张气焰！
绘心言 : 外交部王大大  [赞][赞][赞][赞][赞]
栋腿 : 爸爸脾气来了就是抡你大嘴巴
喵星人带你停药带你菲 : 威武
Mr_Sessica的女孩 : 帅，
The圆子 : 好帅！[爱你][爱你][爱你]中国，必胜！[中国][中国][中国]小人终将自取灭亡！
兰香999_297 : 王毅，我爱你！
miss_雨薇 : 霸气！
Mr步同安 : 强硬、硬汉、我喜欢…
HBCia : 这两天简单问了一些本地人，发现很多本地民众丝毫不care这些事。。
Arthorn1596 : 部长霸气
女孩要蜕变 : 啊啊啊，男神啊！好好治一治小日本！
路的人-人的路 : 王之蔑视
yamadajing : 日方的言行就像强行洗白诡辩的水军，心怀鬼胎信口雌黄黑白颠倒，不恶心死你不算完[哼]，今天成功被恶心倒了，哀其无知怒其无耻啊[微笑]
小仙女yAQiong : 王毅就是帅的没边  眉眼间流露出中国人的自信骄傲
兔斯基你ABC : 我是王毅的脑残粉
瓜大人 : 男神好帅！
丨五空 : 回复@源氏物語110:那就别用中国字。
陕西珂沅环保 : [赞][赞][赞][鲜花][鲜花][鲜花]
卯了又卯ss : 被别完没了...哈哈，只有我觉得好萌吗？
我的心愿是世界和平呀 : 回复@源氏物語110:台湾人走到哪里都抬头挺胸？？呵呵 屁大点一个岛 要不是中国给你们面子 心疼你们被统治了几年 给你们好的政策好的待遇 我看你们怎么抬头挺胸。。。台独的可能是欠教训吧 就是揍过才知道谁才是爸爸
五小媄 : 偶像
我们太无奈Z : 部长艹我
问题少女D : 好帅
LC恣意潇洒 : 祖国真棒，日本应该正确面对南海问题
轻伤不下火线zlp : 别蹬鼻子上脸
程泽林同學 : 跟垃圾较什么劲。
罗小璇睡不醒 : 我单方面宣布王外长是我干爹[doge][喵喵][拜拜][拜拜][拜拜]
南蛮小王爷125 : 中华有您，大幸；日方见了，跪地!
Vae子墨 : 门在那边，滚[doge]
乔治na两年 : 一错再错你又能对他怎样？
别人家的老婆_28646 : 有周总理的风范[熊猫]
xxxx帅出天际boom : 听见没有！小日本[doge]我干爹说话了！
小小钰寰 : 男神
木棉花xwj : 我爱你老王[haha]
图布格日乐 : 回复@atbylolo:男神
麋鹿gained : 回复@源氏物語110:对对对 你不是中国人 也没人说你是中国人 因为说出去丢人 知道不？麻烦您这位外国佬不要再用中文了行不？啪啪 打脸不？？
明星TV网 : 中国越来越牛逼了
RUIDARUI_ : 回复@中华联合省合众国总统办公室顾问:你每天活在钱里，却依旧得不到钱，怪政府怪国家，真可悲[微笑]
L_慧芝姐姐 : 霸气
远山晨雨 : 说的通俗一点就是别给脸不要脸。[哈哈]
L_慧芝姐姐 : 男神
Ann初十 : 男神的表情写着“老子忍你很久了”
豆十三郞 : 回复@源氏物語110:那是你们的干爹干妈，你们当然昂首挺胸啦。而我们是踩美日尾巴的人，当然烦我们了。
繁星四月-小琳 : 啊，男神啊！我外长说得都是对的[微笑][微笑][微笑]尔等不准反驳
mosyRinkel : 回复@Hrhonron:你男神一卡车
哈撒宁咧 : 太帅了[爱你][爱你]
沐沐866 : 回复@源氏物語110:事实上中国也不想要你[可爱]
杨小姐依然年轻 : 王毅部长是中国的男神，
sshhaw : 回复@LJ-ZZOO:公知狗吗？分清楚状况谢谢，国家主权面前不要窝里斗好吗？脑子是个好东西，希望人人都有[拜拜]
Meu啊我是 : 我男神真帅，十四亿人都喜欢[可爱]
__Ooohb1tch : 别没完没了 要不要脸 小鬼子
阿芮锅 : 可以，这样很外长[doge][强壮]
oo破纪鹿 : 简单点说，某岛国就是不要脸
可可0424 : [good][good][good][good][good][good][good][good][good][good]
Bae-xxxibgdron88 : 越来越爱你了 大男神
怪兽小黑张 : 王毅你伸出来的小指头好霸气[害羞]
萌里哒瑞 : 手势解读：我不动手，自己滚[doge]
因为你瞧虎所以我乔虎 : 王毅，这很外交部长。
风云雷电任叱咤-唯我能狂 : 王毅部长真是苏秦仗义在世 给国人长脸了 必须点赞[good]
阳光不收费 : #达人发布# 霸气 [good]
Rachel大颖子 : 大大男神好帅
一个个小雨其实是雨雨 : 干他，小日本[顶][顶][顶]
atbylolo : @图布格日乐
M梅公子 : 打烂日本子的嘴
风子肆肆 : 新一代男神[爱你][爱你][爱你]
麋鹿gained : 回复@就叫董昊阿:唉 真是对台独都无语了！装逼数一数二的
依然饭特稀希 : 王部长就是霸气
SheryZ_ : 我外长说的都对，尔等不准反驳！[微笑]
惪両 : 这是没完没了喋喋不休
繁墨铮 : 为啥看不到评论
Susan_Muzi : 小日本你哪凉快哪呆着去
十月梅10 : 提醒日本别没事儿找事儿！
芳zzzzz : 日本还是给老实点，别到时候惹得起扛不起
源氏物語110 : 回复@麋鹿gained:我從以前就沒說過我是中國人了，因為實際上我也不是，我也沒有中華人民共和國籍，我也不在中國境內~
就是这么酷呆 : 啊，我男神
由梦人dream : 酷酷🙊🙊🙊🙊🙊
中华联合省合众国总统办公室顾问 : 回复@自是思量渠不与-人间总被思量误:所以说，你也承认，在国内土皇帝当惯了，不谙世事，还以为是在国内，记者都是自己的狗？在西方国家，新闻自由可是民主政治的保障，那些正科再牛逼，从来没谁敢去挑战这一点的。知道在国外，多少大官因为媒体的报道下台吗？
疯花雪月夜3 : 我就来看看脑残们发言
一粒小小小纽扣 : 没想到，有一天居然被大叔撩[笑cry][笑cry]，还撩得那么彻底[笑cry][笑cry]
毒蒜重现江湖 : 潜台词就是别老给脸不要脸[嘻嘻]
2033年冯氏集团总裁 : 评论里又看见台独了。你们当然去哪儿都挺胸抬头啊。迷之自信[doge]装的下世界就是你的[doge][doge]
乔木populus : 男神男神我们爱你！你老霸道liao！
物喜-己悲 : 回复@源氏物語110:确实是这样的，我也没针对台湾，只是希望像说慰安妇自愿那些败类，以及大陆在外丢人的那些败类，都能共勉。
人民日报 : 【人民微评：对话远胜对抗】选择对话而不是对抗，维护和平而不是制造分裂，中国东盟联合声明不提南海仲裁，传递出积极信号。那些选边站队的国家没有得逞，那些别有所图的国家该靠边站了。中国东盟本是命运共同体，即便有分歧，也完全可以通过谈判解决，将南海建设成为和平之海。
麋鹿gained : 回复@源氏物語110:赶紧滚吧年 别在这丢人了 要脸不？
未有之味 : 额(⊙o⊙)…我觉得王俊凯好像嫩版王外长大大[笑cry][笑cry]
沐风6002 : 男神[偷乐]
后来的后来的谭 : 霸气
我啊小池 : 顶
Fay耶吼吼 : 绝对男神[心]
每天都来大姨妈 : 迷妹到达战场
麋鹿gained : 回复@源氏物語110:到这来刷存在感？找虐呢？我一向支持留岛不留台独分子！不然以后到哪说你是中国人我还嫌丢人～[打脸][打脸]
za6za6 : 回复@阳光之里:还真是，@源氏物語110 一部讲述日本淫逸的言情小说。终于明白这个家伙，为什么会说自己种族优越了。
December_Monster : 我男神 [爱你][心]
罗罗罗罗罗罗大敏 : 男神霸气
自是思量渠不与-人间总被思量误 : 回复@中华联合省合众国总统办公室顾问:还有，每个国家都存在政治原则问题，中国从来都不是挑事的人，但是一而再被别人说，你又拿我当什么呢，哑巴亏中国吃少了？
乐活人世 : 霸气侧漏[爱你]
糯米糯米你不开花o : 拆除三峡大坝！！！作孽啊！！！
稻米mi1314 : 回复@mm末小雪:东北大学当年被日本人洗脑了不少
881天啦撸 : 哈哈我王家军终于出现这么个有此大将之气的人了！
love萌爱259695 : #就中国还喜欢韩国喜欢的不得了#
营烧雪白愉快 : 直白点说就是岛国倭寇别给脸不要脸[doge][微笑]
干什么玩ling : 都重复得不耐烦了 说没完没了了 一般这种情况下要数一二三了 再不听话就揍了 掐大腿跟啥的
窦1107 : 就是，别天天来烦我
源氏物語110 : 回复@物喜-己悲:是這樣的，政治角力我就不管了，台灣人到美國、日本旅遊，每個走路都是抬頭挺胸的，沒人卑躬屈膝，那是你們中國意淫，因為你們自卑感太強烈，所以愛面子不服輸，旅遊走在路上都想當老大，所以遭人白眼~
小喵微尘 : 部长不想理你并向你丢来个白眼
北巷小歌 : 好帅[馋嘴]
用户5939121828 : 中国爱和平，凡事都会谦让几分，因中国是遵循礼仪之大国，但谦让不代表受气，但更不允许其挑衅！
蒋黎雨 : 回复@中华联合省合众国总统办公室顾问:加拿大应该懂得：他们记者有提问自由，我们部长也有反驳的自由，言论自由是双方的
眼神的延伸轉移 : 顶起
Little_forest___ : 王外长太帅了
中华联合省合众国总统办公室顾问 : 回复@自是思量渠不与-人间总被思量误:额，你还有点良知，那王毅在那里挑衅别人的政治法则，遭到别国抗议，甚至让国家利益受到损失，这个账怎么算？
莫漠杉 : 话不多说，先把赞我家外长威武霸气的都赞一遍再说[doge][doge]
大叔张遇安 : 兼耳只➕
Best不妥协 : 回复@雯kaori:什么玩意儿？
J_COCOA_J : 毅男神又帅出了新高度。
子矜子佩 : 问题是日本啥反应呢？
吧负如来吧负卿 : 外长大大[太开心][太开心][太开心]王之蔑视[赞][赞][赞]
阿彦到此一游 : 中国也是…一个泱泱大国！怎能与弹丸小国如此煞费口舌？[吃惊] 大概是我们信奉儒教。
IT男Jason : 人家一错再错，我们又能怎样呢！！！
Katherine_MYY : 帅气[心][心]
自是思量渠不与-人间总被思量误 : 回复@中华联合省合众国总统办公室顾问:当然能看出来，国家利益优先，钱挣到了就是本事，管你怎么说！？
要对自己好好好好好好好好好的 : 不要惹爸爸生气
岑超Cedric : 周恩来之后再出一位牛叉的部长
麋鹿gained : 回复@源氏物語110:还有点自知之明嘛，我看你打繁体字我也不爽的很[贬低] 真是烦人
岳烜1987 : 帅爆了
雯kaori : 美国 想打谁留打谁，日本 谁打我我让美国打谁，中国 谁打我我骂谁
关心蔬菜的少女 : 现在这位王部长已经成为新任网红了[doge]
葱香麦糊烧 : 回复@LJ-ZZOO:国家机密
Anesthesiacardiac : 孩子爱管闲事煽风点火怎么办？多半是惯的揍一顿就好了[喵喵]
打怪兽i打怪兽 : 打打打打打打。。。然后派我去强奸日本美女，[眼泪][眼泪]
果园农夫style : 回复@向沐宸:呵呵iiii安康幸福
候鸟的等待wait : 霸气^ω^赞 [强]
Wuli小思Cici : 帅帅的外长[花痴]
我有点尔方 : 回复@LJ-ZZOO:66666
用户5874179024 : 回复@中华联合省合众国总统办公室顾问:你搞清楚了吗？它有几大的市場啊。你有病。
物喜-己悲 : 回复@源氏物語110:在我们国家，有篇文章里有段话：”为人进出的门紧锁着，为狗爬出的洞敞开着”不管是台湾人还是中国人，希望都有点气节，卑躬屈膝点头哈腰摇尾乞怜，这些词希望永远不要用在你们或我们身上，有则改之无则加勉。讨论到此为止。
望绿一棵树之树君 : 小日本是不是变成祥林嫂了，逢人就絮叨，没完没了，呱噪得很！
木头人阿Lee : 放开我们王毅[心][心]
平壤詹开艳 : @娱乐天空yl
郭灿烈 : 张局座和王部长。我们中国不首先使用这两人[doge]
就叫董昊 : 回复@麋鹿gained:[笑cry][笑cry]我还以为你骂我二逼呢。哈哈哈哈，真尴尬
我家泰迪不会日 : 不要没完没了！霸气十足
喵丶得瑟 : 意思就是，脚盆鸡，别给你脸不要脸啊喂~
中华联合省合众国总统办公室顾问 : 回复@暴君小熊熊:少在那里颠倒是非，我在这里发言就是因为我爱国，王毅损害国家利益，你怎么不去声讨？还在这里捧他的臭脚，你爱的到底是什么，你的主子还是你的国家？
猫腻966 : 回复@源氏物語110:我跟你说我现在看见繁体字就烦 不承认？ 优越感 你中国爸爸们还在这呢 谁给你的勇气[微笑]
小念是个好姑娘 : 你怎么净说大实话啊男神
准基饭家的大云儿 : 王毅也爱你[害羞]一会过来再表白一次
老师快来教我取名字 : 回复@水莱雅保湿补水面膜贴:对，他说错了，我们可以放他一马。但是一定要他记住，我们不是放马的
李昇炫的茫茫 : 回复@阳光之里:[doge]这就TM尴尬了
祺ZQQQQ : 男神帅！！！
美棒的当 : 看到干爹就不由自主地点进来了，完全是因为干爹的魅力[色]
卡毛卡毛给我感觉668 : 作为王毅外长的脑残粉，我必须点赞！
麋鹿gained : 回复@橙子小小粒:我还不希望台独分子回归祖国呢[doge]能打死最好了[坏笑]
中飞院神经科主治医生 : 卖黄碟的，谨言慎行好吗
马镭说她想去英国 : 男神男神！！！
Lee的小熊Leo : 可以  这很王毅  这男人  酷毙
暴君小熊熊 : 回复@中华联合省合众国总统办公室顾问:别闹了，不爱在中国就去别的国家
萌点CJ奇怪 : 男神刷一发
旧井深巷 : 可以，这很外交部长[笑cry]
老师快来教我取名字 : 回复@RilkeanHeart7:我现在搞了他这个发型，hold不住
娆娆姐姐圆圆脸 : 真霸气！！
13级公管哲一 : 怎么没有人评论点赞？
_海倒过来是天V : @李文洁lwj 帅的不要不要的[色]
好运_89030 : [good]
扶苏的芙子_ : 王之蔑视[doge]
Moment--Z : 继续说又能咋地？
水莱雅保湿补水面膜贴 : 你不能只一味恩奉劝奉劝奉劝，做出点行动让小日本知道咱不只会奉劝行吗老大
我就觉得这样挺好的 : 这不是奉劝，这是警告啊龟砸[doge]
曼蒂造型机构-夏天 : 男神[赞]
难忘的愚人节k : [喵喵]霸气
顾左言右_ : 我是中国的脑残粉
麋鹿gained : 回复@就叫董昊阿:我知道啊 我在跟你说啊[哈哈]
Alice骑着蜗牛毕业啦 : 门在那边，好走不送[doge]
黑孑哲也 : @日本国驻华大使馆 快滚出来
优佳爱婴 : 王毅外长好像没有只有大背头，别的好像一般。
大斌Dove宝贝 : 日本这个欠儿逼。
小柒_Dowson : 没完没了
九难- : 表白王毅爸爸
生活区长 : 还是那句话，当年两个蛋……日本还能承受几个蛋？[吃惊][吃惊][吃惊]
就叫董昊 : 回复@麋鹿gained:[拜拜][拜拜][拜拜]你艾特错人了，我不是台独
盲降截获 : 男神发话了。
雨花石花飘飘 : 不要一错再错，小玉女也是这么认为的[微笑]
JeongTaekWoon- : 帅炸了！！
Libra-lolu : ：这头雄狮早已醒来[中国]静待时机把你们蛇鼠一锅端
赫拉LI : 他们在声东击西，其实主要目的是萨德吖！！！！！
丹心木槿 : 霸气的王外长，支持你[鲜花]
as61591 : 在嘚瑟我就抵制你的电影了！
清廉有多难 : 嘴炮[笑cry]骨子里都烂透了，死鸭子嘴硬
景瑜的小跟班 : 毅力哥就是这么帅气[嘻嘻][嘻嘻][嘻嘻][嘻嘻]
物喜-己悲 : 回复@源氏物語110:现实就是，你们只是大国博弈的棋子，保持现状你可以继续优越你的150国，一旦有事棋子终究是棋子，美国为了你们打世界大战？另外，你们选上来那个绿绿，中文都说不好，在我们这把这种人叫香蕉人，黄皮白心。
啵啵虎_roooook : [向右]别瞎吵吵一边去
嵩家的潇潇 : 我想说:干得漂亮
源氏物語110 : 回复@高射炮团长:228的帳我都還沒跟他算勒，他來找我正好，再把他踹進地獄一次，終老也太便宜這個蔣魔頭了~
远山横波 : 关你屁事，你丫闭嘴。
李新梅61737 : 这手势意思是：门在那边，自己出去～不送！
麋鹿gained : 台独分子滚粗，日狗美狗滚粗！少在这丢人现眼辣眼睛了[贬低][贬低][贬低]
天马行空stark : 王长的意思是：与你无关，你就别犯贱
缠中缠千股 : 瞅，日本这个泼妇。
中华联合省合众国总统办公室顾问 : 回复@自是思量渠不与-人间总被思量误:你蠢，但是你起码应该知道，与加拿大做生意是可以赚钱的吧？因为记者提了一个自己不喜欢的问题，就赤裸裸的挑衅别人的政治原则，引起别各国政府的抗议，甚至搁置了贸易协定的签署，孰轻孰重你看不出来？
M_Aha : 别一错再错 没完没了！
善良有用吗no : 单方面宣布这是我干爹[可爱][可爱][可爱]
黑和蓝 : 回复@南南北北1225:你觉得像不
TTBuBuBuBuBuBu : 表白wuli外交部长！！！
吃土的污女 : 王部长太帅了！
Agoni : 感觉王毅的那个手指最帅
很久以后的Yr : 男神！
MS唱天真小姐 : 说的好！爷们！
TST活醇母总代_超超 : 必须转起
叁七尔失依 : 霸气！
牛牛去兜风 : 这叫做霸道，帅气[赞][赞][赞]
NT神 : 王毅我男神。[爱你]
小彧-愛陽光明媚的日子 : 日本的潜台词就是你打我啊！[微笑]
TsingHa_ : @J江大脸 好帅
Tang_ssica : 男神就是帅[doge][doge]
小满butterfly : 可以，这很王毅。
时光是停留还是不停留 : 日本政府有病吧
依然茶色 : 霸气
猫腻966 : 我的男神
谁敢说自己是猪 : 我爸爸就是这么霸气
大美hehe : 门在左手边，再瞎吵吵滚出去[向右]
Cindy___Tam : @王雅yaaa @Winson-明 @A-jin昶儒
麋鹿gained : 回复@就叫董昊阿:二逼，台独分子就是活着浪费空气死了浪费土地！大晚上的还来给我恶心一把，[吐][吐]
雅雅家的牛奶 : os 没完没了了还
草莓莓草莓草莓 : 回复@源氏物語110:搞不清白的是你照你的意思台湾不仅是一个国家大陆还要给钱养它你想的倒挺美啊这么多年惯你还惯出脾气来了没有大陆爸爸你有现在的日子吗不喜欢就走岛是中国的找你的美国日本爸爸看他们要不要你到时候别哭着回来求中国爸爸收留你
豆浆稀饭面皮子 : 看评论感觉有个人想上头条[微笑]
SSSSSong_ : @灰色Echo
洋宝宝蛋蛋狼 : 周恩来的赶脚[可怜]
我只是想试试能不能改名 : 回复@源氏物語110:连一个卖芒果的都比不上的地方来的人在这里叫嚣？谁给你的脸？
又见小7 : 霸气
王小墨她爸 : 嘚嘚嘚嘚半天。  人家都不鸟你。
懒虫---橙二妹 : 蜀黍好帅！[爱你]
柯基家的小钱钱 : 没完没了哈哈哈哈哈这是嫌弃到家了[笑cry]
阳光之里 : 回复@李昇炫的茫茫:看他ID就造了[偷乐][偷乐]日本在很久以前只有天皇和少数贵族有姓，天皇的私生子赐姓源，《源氏物语》这本书讲得是日本皇室乱伦，差点混淆血统的事（恶心到我了[抠鼻屎][抠鼻屎]），但不知道为何在日本很受欢迎~~
屁屁醒了 : 回复@孙喵喵还是孙猫猫:我没有十分高尚，但一定敢于直言。不仅仅是在微博里。现实中亦如此。国家兴亡匹夫有责我也明白。如果外侮敢来，我也愿意为祖国扛枪上战场。但是，不好的就是不好的……如果连自己家里人都不直言以对，还能让谁来振兴中华呢……但是，犯我中华者，虽远必诛！
wuli陈叔 : 就是这么强势[喵喵]
Miolhnc : 男神霸气[赞]
自是思量渠不与-人间总被思量误 : 回复@中华联合省合众国总统办公室顾问:你没在那个位子，你又知道怎么做是对的？我等愚人，求您解惑？
橙子小小粒 : 回复@源氏物語110:什么不承认武统？台湾主动要求回归的话可以不武统！不然中国网友都是支持留岛不留人的，不服就干。看看美国爹来不来。[可爱]
神救救我吧啊 : 男神把我带走
F__moon : 麻痹欠揍
菇凉天生傲骨sjy : 好样的，[花痴][花痴]
MileyCoco : 男神爷爷霸气，发话了，小鬼子、高丽棒子都消停点
中华联合省合众国总统办公室顾问 : 回复@安冬尼的小王子:你自己去twitter上面搜。
馍加烤肠 : 王大大太帅啦～新晋男神[爱你]
我冷漠薄情_你功不可没 : 什么小鲜肉，什么追星，什么美女！统统都一边凉快去，这才是我的偶像！
-P6NG : 别没完没了，霸气[good][good][good]
阿贤少女啊 : 我男神
九云大人_ : 王毅大大想：有完没完了，你们烦死了～
BLing3Linn : [good][good][good]
oo00- : 没完没了[偷笑]
物喜-己悲 : 回复@源氏物語110:智商这事，你还不了解。我已经说的很清楚了，没有一个领导人会让台湾独立，没有人愿意被写在历史书上。所以别人说的是不想武统，而你的理解是不会武统。可见智商这事和你真没什么缘分。
安冬尼的小王子 : 回复@中华联合省合众国总统办公室顾问:请您发给链接[微笑] 不确定我刚才的回复您收到了没
中华联合省合众国总统办公室顾问 : 回复@爱幽蓝79297:本来只是个常规的记者会，最后引起别国政府的抗议，甚至一个国家元首两度出来发声，你没意识到事件的严重性？
宝宝愿世界和平 : 日～回头是岸
郁暁貓 : 比洪磊霸气[强]
艾爵隐形眼镜美瞳咨询顾问 : 艾爵180蕾丝半年抛：1片装；中心厚度：0.09；含水量38%；直径：14；基弧:8.5；颜色：黑色、灰色、棕色、紫色、蓝色；产品特点：低含水量，不容易沉淀蛋白。原价[钱]148；现价只需[钱]98元。
牧木-ZACHARY : 没完没了后面加上各地区方言吧，没完没了，磨磨唧唧
豆豆橘妹 : 最近的外交部666的不得了 再也不是什么谴责谴责 强烈谴责了！！！引以为傲[兔子]
李昇炫的茫茫 : 回复@源氏物語110:我说的就是你[微笑]一台独也好意思在这刷存在感[微笑][微笑][微笑]
YongForever_89-XFF : 帅气[good][good][good]
新闻比比皆是 : 回复@源氏物語110: 不管你接受还是不接受，台湾就是中华人民共和国不可分割的一部分。
沐沐866 : 回复@源氏物語110:有种你想炒作自己的赶脚[可爱]
Z丶小番 : 说的这么强势，行动呢[哼]
爱幽蓝79297 : 回复@中华联合省合众国总统办公室顾问:那还不明白吗？如果政府真的觉得他的发言有问题，为啥还让他在这活跃，难道政府不知道选他就是代表政府的态度的嘛呵呵哒
FOOOO咙咙 : 男神啊男神[心][心]
牛鹿灿_ : 我爱豆！
萌小晶 : 回复@意大利足球新闻:有道理，弱国无外交！
OwenRommel : 你爸爸我烦了[doge]
绿玉春犹倦 : 倭寇以为机会来了！三个大国把它碾成齑粉！
谢xiujia : 转发微博
123曦101 : 帅炸天
总管太监周莲英 : 柬埔寨是南海仲裁当事国吗？
东边儿X : #河北邢台# 借话题！#湖北天门抗洪# @共青团中央 @央视新闻 @凤凰网 @凤凰卫视 @中央人民广播电台 @湖北省政府门户网站 @楚天都市报 @央视新闻周刊 @央视新闻评论 @中央气象台 #河北邢台#请大家关注一下湖北天门[祈祷]🏻[祈祷]🏻[祈祷]🏻[祈祷]🏻[祈祷]🏻[祈祷]🏻[祈祷]🏻[祈祷]🏻[祈祷]🏻#天门分洪#
大风吹o_O : 我的小龙人真帅
Feliciiia : 真是的，什么都来凑一脚，硬是把白的说成黑的。。小国家就是小国家，像个怨妇一样整天抓点东西就开始炸毛做文章[哼]
郑烨婵 : 长得好像爷爷
DaisyAyo : 右边智障[向右]
我怕今后娶我的D人不是你 : 我的男神，太帥了。
白芍zyx : 王之蔑视
润泽心田A : 顶
yj_amw瑜 : 大爱男神 别没玩没了→_→
玉新LB : 没完没了  这四个字[doge]
火狼RX : 给小日本发个警告单，好样的
zero吉家家厨具 : 回复@源氏物語110:台湾迟早要回归，谢谢，大势所趋[微笑]，不用谢
蒲公英heaven : 霸气[赞啊]
世界之大真是无其不有 : 打倒日本帝国主义灰复，一定要灭绝日本人，先灭掉安倍晋三狗日[怒][怒][怒]
源氏物語110 : 回复@沐沐866:沒有耶，一開始我在每個新聞底下留言發表該新聞的看法，但是很多中國網友看到我打繁體字，就開始跑題~二戰啦、國仇家恨啦、國籍不同的立場啦~我也不想阿!!
老大的椒 : 王毅又一男神[爱你]
他有满满一屋子阳光 : 部长好厉害啊
中华联合省合众国总统办公室顾问 : 回复@爱幽蓝79297:王毅那个德行叫质疑？他不是个人他代表的是一个政府，一个国家，一个外交部长都不知道谨言慎行，还外交部长？你以为是你们家里，你老爹对你训话啊？
午夜凌晨十二点 : 说安倍就是在说美国，因为安倍和他外公都是美国培养的，日本驻军也是为了保护日本那些仇华势力
纠结症vv : 真的是没完没了啊。爸爸好累。你个小日本，别人的事，看把你给操心着急的啊
君君小胖纸纸胖小君君 : 王毅说什么就是什么[微笑]
芒勉- : 翻译:你个日本鬼子再瞎蹦哒爸爸一枪毙了你
真的不吃猪肉 : 对呀对呀，不然车又不好卖了
物喜-己悲 : 回复@源氏物語110:还有，你的优越感也并没有什么卵用~你们喊着自己祖母做慰安妇是自愿的时候，心里盼望着你日本爹赏口饭吃。你说几等公民，那么请问你们慰安妇的祖母在日本大兵胯下挣扎的时候，这个大兵觉得你们是几等公民？
Hrhonron : 男神[哆啦A梦吃惊]@mosyRinkel
Azariasf : 别老死皮赖脸给脸不要！
多谢您的支持 : [给力][给力]@佛山活乐文化 @坚持_198303 
丿薇妮 : 没完没了这句特别恰当[爱你][爱你]
柏卜 : 在这么不要脸的纠缠，打你的时候别哭
随缘不随便之 : 小日本也是绝了，南海不是你家，天天嚷嚷南海仲裁，只有你们仨(美日澳)认同的一张废纸，连菲律宾都不好意思拿出来谈了
琪梦童 : 部长威武[威武][威武][威武]
ToshibaZ : 我觉得王毅长得这张脸永远都是一种强硬 蔑视的表情[doge]
晕水的鱼218 : 真正的霸道总裁范儿
二分之叁- : 帅炸
抹茶味的肉 : 帅啊
Vivian泡泡袖 : 没完没了这个词......
沐沐866 : 回复@源氏物語110:你是不是想红啊，怎么老看见你跟别人吵吵[doge]
_Manymany_ : 帅！！
南南北北1225 : 回复@黑和蓝:你丫想死啊？
权志龙south : 每次国家问题面前，觉得我们都是一家人[心]特别好
看星星的北极熊775 : 感觉这口气像是大人训孩子！
心随已愿言之命至 : 外长还有美人尖，外长的眉毛真的好英武不凡，相信外长单凭颜值就可以称霸世界外交界，
在说话的耳朵 : 视频才有看头嘛
郑阿璐 : 评论里那个源是物语是个sb吧
木林森水沝淼金鑫鑫 : 奉劝日方不要一而再再而三的给脸不要脸
南南北北1225 : 丫的小日本就是踏马欠日。
长安维军 : 钢牙利齿/[威武]
兮日清晨 : 王叔叔捂着脸，叹息道：md，可算是狗日的，狗日的啊，给脸不要脸！
已成桑田 : 识时务者为俊杰……[微笑]
爱幽蓝79297 : 回复@中华联合省合众国总统办公室顾问:那既然是探究，别人的回答你接受就接受不接受就不接受，只许你提问就不需别人质疑了，这是什么逻辑？
源氏物語110 : 回复@物喜-己悲:上面還有個中國網友才說中國沒人想武統台灣勒~你這麼快就承認了~這不是打臉什麼才是打臉?!
迭里迷矢 : 戏子
小美美non : 再得瑟收了他
小茉莉-Ha : 这个部长我喜欢[微笑]
Denise牛肉 : @W-Space05 王毅是我男神[微笑][微笑]
阿姑的小牛奶 : 而日本说 别几把bb 弄不死你。这几句话却没被报道。。
Lean-FZ : 通俗翻译：小日本真他妈给你脸不要脸了[笑cry][笑cry]
Annabelle燕儿 : [爱你][爱你][可爱]
2000Tany : 很强势嘛
小卓飞 : 可以在霸气一点
蓝哥后援团团长 : 没完没了这词儿说明我们真的烦了[微笑]能别逼逼了吗[微笑]
中华联合省合众国总统办公室顾问 : 回复@用户5874179024:现在是中华民族的利益受到了损失，你为什么不去捍卫？你知道什么叫爱国？
微笑gogogo : 此处有掌声
赣州路桥 : 就知道帅帅帅，事情本身不关注。
你好我叫岳漂亮 : 小日本天天的有完没完？
就这样k祥彬塔 : 就是喜欢这股霸气[鲜花]
好好小姐lyy : 男神
一堆狗粮_ : 男神男神[心][心][心][心][心][心]
MsSun00167 : 不要一错再错！没完没了！
良光天庭 : 回复@向沐宸:变态
i李泰萌 : 好帅气阿
我四lgy : 我不管，他就是我男神，我干爸，我神
用户5874179024 : 回复@中华联合省合众国总统办公室顾问:你们就是一群不知中华民族的畜牲
慕容琳儿_Jolin : 感觉就差再说一个滚了[doge][doge][doge]
亲爱的小hai孩 : 回复@LJ-ZZOO:每个人到了一定位子都会有一点吧，一个公司的小主管都想办法捞钱，别说ZF了
Liar0504 : 新晋男神[心][心]
ZZHangziHaang : 说让王毅公布财产的那个热门 恕我直言 你是傻逼
物喜-己悲 : 回复@源氏物語110:你说了这么多有什么用…台湾永远没能力也没机会宣布自己是国……没有一个领导人愿意在自己手上让台湾这么做。那么问题来了，面对最后的武统压力，好贵的台湾人该如何应对？靠美国爹吗？对不起，美国爹眼里你们并不是儿子，面对火箭炮可以打的地方，什么反导有用？两个舰队凭什么和岸基打？
临沂临港发布 : 帅啊！
Meng_ST : 帅呆了
k小龙虾 : 周总理的即视感[喵喵]
喵小亲的行李 : 日本又来刷存在感了吗？屏蔽他好了
ayisheviviotk : 王外长你帅炸了[强壮][good]
可爱阳光屋顶 : 曾经不光彩的历史没有让小鬼子回归人的本质，反而上蹿下跳，充当美柜人前面的跳梁小丑，实在让人恶心…[打脸][打脸]
三七年十月十 : [嘻嘻]中国的炮弹绝不会对着人干 欺负咱中国的会以牙还牙
huali續 : 日本人真是不值得原谅。良心太坏了
love-you-angle : 说的好
心随已愿言之命至 : 我家外长那么帅系列
小桥薄荷 : 高冷又犀利的男神
冷彦汐 : 一个大写的帅
李昇炫的茫茫 : 回复@源氏物語110:不要再找存在感了[微笑]中国爸爸不稀罕你一个[微笑]去找你的美国爹爹[微笑]
淮北吃喝玩乐 : 我男神[心][心][心]
崔美美aa : 帅出新高度.威武
超级幸运王八biu哒 : 看见我的祖国说话这么直白我也就放心了[doge]日本狗子不要没完没了哦[偷笑][doge][doge][doge]
重口味的包子君 : 回复@源氏物語110:历史没学过？台湾是哪儿的不知道？上过学？读过书？他么中华民国都没了多少年了还尼玛没醒过来装孙子呢？哈！
晗晗晗_34483 : 王的蔑视！[good]
开拖拉机送你一车百合 : 什么时候大战我也好去当兵，搞个将军当当啊，不打战不给机会啊
SYLVIA199725 : 帅！！！
大垚y : 男神就是这么霸气
浅紫七七 : 霸气(°ㅂ° ╬)我男神真帅！
吃了两碗的粉给了一碗的钱 : 给小日本上去就是一巴掌
江边一老叟XJ : 部长，其实我也姓王，支持你，支持党，支持祖国
我的脑公文艾力先生 : 回复@中华联合省合众国总统办公室顾问:你说吧 你爱国爱在哪里 我想看[微笑]
DYQ大大 : [拜拜][拜拜][拜拜]王大大心中旁白:我有粉丝千千万，我的粉丝可以绕日本30圈，给你个眼神自己感受[doge][doge]
任渭房 : 日本什么时候对过，他错了就错呗，你着什么急呢，还不要一错再错，真心为日本好，你就管他，要是不想日本好就不要管他嘛。
婉婉王smile : 毅大大：再没完没了，打死它个龟孙。[doge][doge]
寻觅遗失的梦忆 : 怎么啥事都想桶下，当你是搅[大便]棍吗？，就算是！也得看有没有人用你[弱]形容不恰当我下意识想到这个形容词！
咚鹿宁就酱 : 帅
一潭星G : 帅死了[拍照]
以后谁也不迁就 : 小日本真他妈的给脸不要脸
_張張張張先生 : 男神！！！[色][色]
未来-forever : 男神，帅[微笑]
不自爆不清真 : 长得帅真尼玛顶饭吃
晏花初雨 : 美国都闭嘴了，日本还强撑干什么
A大雾里的胡同 : 帅[good]
F-vining : 就是帅！[干杯]
BAIGE_BG : 要被王毅 圈粉了[好爱哦]
Oldtimes-Y : 回到中国爸爸的怀抱、做中国爸爸的一个省、中国爸爸就给你言论自由权。当儿子总比当狗强。
议长zzz : 和疯子少说话，必要时多做事就好了！
Influenza_ : 男神男神[爱你]
广府paul : 回复@宙斯传奇song:就是打嘴仗吧
让我看看谁在装逼 : 钓鱼岛收回来了吗？
一个小仙女罢了哦 : 我王毅大大好帅[花痴][花痴]有他在可以放心了[喵喵]
谢娜娜童鞋 : 没完没了这词怎么用的这么好[哈哈]
右耳鑽思戀92182 : 好帅
7love小鱼儿 : 什么叫霸气？！！这就是！！！
沙与沫沫么 : 男神就是帅气
木林森水沝淼金鑫鑫 : 奉劝日方不要一天到晚，给脸不要脸
蓝胖子暖暖的 : 转发微博
WEI家闲民 : 美国老大发话，日本哪敢不从
Zfeng522_ : 翻译一下就是，关你屁事，滚几把蛋，再找事老子弄死你！艹你妈的臭high[握手]
吃我一香蕉 : 像我一样想要王部长签名的赞我！！！
康乔夏天十九岁的肖像 : 小日本就像无理取闹的泼妇
wisdom-charm : 帅[强]
中华联合省合众国总统办公室顾问 : 回复@暴君小熊熊:所以，你们的爱国是不用依据事实的？
尤耷 : 就是，关你什么事，还有完没完？？
新闻比比皆是 : 回复@源氏物語110: 联合国承认，台湾是中华人民共和国不可分割的一部分。这种事你怎么想都可以，但是，改变不了事实的。
小姐你再过来我就叫咯 : 我单方面宣布日本仔是我家旺财的孙子...
YE-C-H : 帅气的部长[强][强][强][强][强]
不不不不要嘛 : 回复@中华联合省合众国总统办公室顾问:您厉害 听听您想怎么说。
芳子Betty : 帅！我大国气势[害羞]
YTY233 : 我大中国的大外交部[强壮]
中华联合省合众国总统办公室顾问 : 回复@自是思量渠不与-人间总被思量误:你这么偷换概念，我就懒得跟你扯了，我就想表达王毅当了某些人的忠犬，损害了国家利益，却被一群猪脑子捧臭脚，中国人的爱国也就这德行了，你们根本不知道自己爱的是什么。
光着膀子跳探戈008 : 安倍晋三表示不甩→_→[酷]
他是我努力的不竭动力 : 回复@那些年贰哥:儒表法里
Tan家小胖爱喝酸奶 : 顿时觉得这个男人好帅
筱芸happy : 这里的评论和上一条新闻的评论，简直是两个世界，上一条新闻，喷子键盘侠太多，辣眼睛。。。
石落初晓时 : 好霸气！我喜欢！
裴彪会飞 : 日本就是一个搅屎棍
蓝莓酱大大TAT : 意思就是说，小兔崽子再在那里瞎BB,小心爸爸打你[doge][doge][doge]
Sonnenblume-f : 回复@韩亚乐ing:汉奸比侵略者更可耻可悲[拜拜]
Super王楠楠 : 回复@同学王云:次奥
橙子女王陛下 : 回复@LJ-ZZOO:不管咋样，敢那么霸气的为中国说话就不错哒
孙尚香217 : 对待无赖说话就得硬气点儿 要不蹬鼻子上脸了 软硬不吃就特么开揍了！
缚己_ELLE : 搞得事出来 别总是那么被动 难道不应该给美国日本搞点麻烦吗
宁包子haha : 再嘚瑟不看你黄片了
CZ_久伴情深 : 支持
jamilywen : 男神
婷惜右眸 : 回复@源氏物語110:去找你的美国爸爸
汐雨L : 王爷爷太帅了，王爷爷好样的，日本就是哪里有事往哪里钻，简直是唯恐天下不乱呀
mei美啊 : 好帅
从余9527 : 回复@源氏物語110:操你妈逼日本杂种
似幻似真丶 : 外交部：送你去上天[微笑]
急速冷冻鸡翅膀_Lv99 : “不抽你嘴巴子你还没完没了了是吧？”
他是我努力的不竭动力 : 简直帅！
南音1021 : 太帅了[心]
源氏物語110 : 回复@劉凱旋将军:台灣是中華民國ROC阿，誰管你承不承認，你又不是中華民國公民.....
Mr_YIN-小姐 : 帅
自是思量渠不与-人间总被思量误 : 回复@中华联合省合众国总统办公室顾问:那么，请问，加拿大耗得起还是我们耗得起？
想摘星星的啊庄 : 安倍啊，你听点儿话，好不好！[doge]
交缠vale : 真的是太帅了
王亶文 : 得狠狠地教训小日本一次才有效。
Zoe_D : 霸气
源氏物語110 : 回复@高射炮团长:你有看過免簽150國的二等公民?你尊貴的一等公民護照免簽幾國?
麋鹿gained : 回复@烂笔头666:对对对！说得好[good][good]
一朵诺顿花 : 迷妹报到！[色]
韩亚乐ing : 回复@Sonnenblume-f:台湾人比日本人还讨厌[害羞]
暴君小熊熊 : 回复@中华联合省合众国总统办公室顾问:你是思想策反？
_Didiane : 别把中国的谦让，当作不要脸的借口。
张青春啊 : 第一眼看见他的时候就觉得超帅[拜拜]
朔缘说 : 男神
那些年贰哥 : 内圣外王，王霸之道杂糅
S已然被热成一条咸鱼 : 完全变成这届外交部迷妹
海边的一等带刀侍卫LL : 弄死他狗日小日本的！
指间缭绕的旖旎 : [爱你]报告部长，台湾有智障又给你添麻烦了，要不要考虑收回来好好教育教育，被蔡英文那个傻x教育的连脑子都没有了。
心寶独爱奇奇威 : 国民男神
高射炮团长 : 回复@源氏物語110:二等公民，手下败将！
Jestin2012 : 不是说不见嘛？怎么又见上了。
皮皮的姐姐狗姐 : 我男团队长，帅
王小闹是个熊孩子 : 王外长真是男神[色]，这就是大国气度[兔子]
HCY月光女神 : 正在军事男神，讲的话太牛了……太帅了
Linglin_sun : 太帅啦～～[赞][赞][赞]
莼真年代L : 部长太帅了，男神啊！！
魔鬼用户 : 这才叫男神[噢耶][噢耶][噢耶][噢耶]，部长大人，能不能也这样去收拾弯弯啊！一整天没事净作妖。还向美国请愿。[doge][doge]实在不行把那些台独全清理出中国得了。我们只承认台湾的领土问题，可不承认那些没脑子的台独啊[推荐][推荐][推荐]
猫扁扁 : 得了，以后就打算有这个台词了，我劝你不要没完没了～
我叫-阳阳 : 霸气
Wwwu_oohsehun : 哇真棒[爱你]偶像啊
Lady思妮达 : 表白男神部长[爱你][心]
QQ行成于思毁于随QQ : 日本，一个要潜入海底的国家，想想就高兴[开心]。
ZHUJIAN- : 直白点就是，跟你没关系就别出来BB
丨biubiubiubiu丨 : 翻译：我正在给菲律宾猴子颜色看，小日本不要看不清颜色的站出来，小心揍你。
流鼻血的皮卡丘 : 王毅部长真是太帅了
孙喵喵还是孙猫猫 : 回复@屁屁醒了:[微笑][微笑][微笑][微笑]
度度地盘 : 偶像
Mxsssss : 日本就是个卖黄片的
Sonnenblume-f : 回复@源氏物語110:不好意思呢台湾是我们中国的名字也是中国赐的[微笑]请不要妄想盗取[挖鼻]懂?
SixGod奢侈香水代购 : 其实王毅大大的话挺委婉的、他的语言简化来说、就是“小日本、南海关你狗蛋事儿～”
翱翔的自行车 : 打丫狗日的
冰淇淋的森林木 : 帅气
不知哪块小饼干 : 回复@专业代购瓜子:[鼓掌][鼓掌][鼓掌][鼓掌]
帕米尔骆驼 : 若干年来，中国苦口婆心地奉劝了无数次，都把自己说成了&quot;祥林嫂&quot;，有一次见效吗？对狼狗耐心说人话，它听得懂吗？光吆喝，不见大棒挥舞，不疼不痒的，还有吃有喝有胡萝卜，再蠢的狗也不会自己离开！
RilkeanHeart7 : 回复@第十三生产队小牛:大大，网络用语，用作对高手、牛人的称呼，表示对某人的崇敬或膜拜。喷之前请先查一查[哈欠]
劉凱旋将军 : 回复@源氏物語110:没用台湾这个国家，历史上台湾就是中国的，你不承认不行啊
写意秋词 : 帅
太原阿里巴巴烧烤专家 : 我的超级偶像[赞][赞][赞]
曼儿酱 : 最近喜欢王部长的是越来越多了[赞]
鹤麟斋主 : [给力][给力][微笑]
小潇仔_ : 男神说什么就是什么
雷妹子阿 : 回复@源氏物語110:你的美国爸爸都不敢这么说
源氏物語110 : 回复@草莓莓草莓草莓:ROC中華民國台灣、PRC中華人民共和國~你連國籍都搞不清楚?!
你说你到底逗不逗 : 回复@源氏物語110:“侵略”意为对他国非法国土兼并。如果你说“‘侵略’台湾”就已经把台湾省割裂出去了。这也是大家喷你的原因。没人想武力让台湾回归，让台湾同胞受到伤害，但大陆会做好这个准备。
唐朵兰 : 没有实力的抗议和愤怒是没有任何作用的，祝愿我们国家越来越强大@唐朵兰:爱我中国！加油！日本怎么老这样过分，中国就需要要用实力说话！
Sonnenblume-f : 回复@韩亚乐ing:可fa[眼泪]我才不要和他做同胞
冷-冷-碎 : 回复@WilliamWallac:好吧，再见！
小太阳的老菠萝 : 其实我们的本意是要派悟空把你给收了
皮卡丘乒 : 回复@LJ-ZZOO:你说话这么讨厌，你也公布下财产吗？
骑着蜗牛看风景22580 : 王外长：你们日本政客不要不识抬举，迟早让你们吃不了兜着走[阴险]
中华联合省合众国总统办公室顾问 : 回复@爱幽蓝79297:屁话，当然如果涉及国家机密可以依照法律，选择不回答。这个不对新闻自由构成妨碍。但是你那个以事实为依据是什么意思，提问难道不就是在探究事实？难道拿通稿发新闻的才叫依据事实？
那一天我们毕业了 : 王部长好帅[爱你]
源氏物語110 : 回复@Sonnenblume-f:我的確不是中國人，我是台灣人!
酷得有hunnie : 我公公，您儿子在哪，我要带他回家
请叫我大帅- : 大大很帅呢[给力]
CHENGDUODUO- : 帅就一个字  我要对你说一万次
真正的快乐不是假的 : [强]
千年翰墨 : 还有一段不光彩的历史[doge][doge]
小梦sky张婕 : 请岛国出去。
刘氵其喂自己袋盐 : 我想学日语，不为别的，只为打起仗来可以做个翻译，或者打入敌人内部
草莓莓草莓草莓 : 回复@源氏物語110:麻烦多读点书再说话台湾也好意思称中华民国说出去笑掉大牙来我告诉你跟着我练中国台湾省[微笑]
嫣-衾訾 : 男神！！
用户3777975643 : 中国对外宣传，尤其是对美国要以美国歧视无神论作为攻击目标，批评美国不给无神论应有的政治地位
feelyu : 这两年越来越硬气了[微笑][微笑]
一张面具啊 : 回复@沉默的李大兵:先回复你，然后举报你，
大树君心里有一棵树 : 这个没完没了，配上王部长的白眼，简直完美
冰镇西瓜七 : [good][good][good][good]
俊腿蟹妻 : 王毅是男神♪～(´ε｀　)
时光-孤独 : 说得好
千千笑笑生 : 王部长，帅帅的，我为部长点赞！
重口味的包子君 : 回复@源氏物語110:台湾本来就是中国的，会看地图么？你家地图台湾在美国啊？
___巴拉巴拉正能量的小萌子 : 开玩笑 以前王男神是驻日本大使  日本人那脑瓜子想什么部长当然知道[doge]
礼茶茶茶 : 一错再错 没完没了 哇 太帅了好嘛
SHORT : 小日本纯粹是为钓鱼岛报复中国。这条美国狗！真的很膈应人。
全世界最帅的世勋 : 日本这个国家真是烦死我了
Clofia蘇不蘇 : 日本右翼好恶心啊[怒骂]
任纤森_黑人 : 送日本四个字！不！要！碧！莲！
只想吃榴莲 : 东亚外长会议[傻笑]
嘎嘎83950 : 我的新男神
王老师596 : 我的男神，以后只崇拜你了
在下超可爱t : 超级帅
萬_小_娜 : 他为什么总是这么霸气！
歪呦咦 : 我是您偶像，给我签名给我签名[爱你]
Hey-CM_ : 日本人没完没了还[斜眼] [斜眼] [斜眼]
佳嬷嬷 : [挖鼻][挖鼻]王之蔑视
雷妹子阿 : 评论里怎么总有那种自以为是众人皆醉我独醒的人
WilliamWallac : 回复@冷-冷-碎:你的话也点醒了我，谢谢仁兄
rangers小冰 : 论一个国家外交官的重要性
草莓莓草莓草莓 : 回复@Sonnenblume-f:真的是我晕
小柠檬大未来c : 男神
Sonnenblume-f : 回复@源氏物語110:开心就好[作揖]要一直开心哟[害羞]永远也别承认你是中国人
我就是李双就是我 : 帅气
小卷卷旭 : 王的蔑视
easestone : 这个外长是真心威武，硬！
中华联合省合众国总统办公室顾问 : 回复@Support111:很简单一个逻辑，我给你挑明了吧！王毅因为要维护某党的面子，在记者会上斥责接着提问，作为一个高管很幼稚，当即遭到加拿大政府的抗议，加拿大总理两度发声给记者撑腰，表示坚决捍卫媒体的新闻自由，随后加拿大搁置了和中国在很多方面的合作。懂了嘛？
大骗子大坏蛋 : 日本鬼子作恶多端！[哼]
吉吉一号的铲屎官 : 就是喜欢这么硬气
哈喽WYY : 王毅！[爱你]
神回复搞笑君 : 这我王叔
WilliamWallac : 回复@冷-冷-碎:评论不能单方面，他也有他的弊，但也有利。我承认我对他的看法有点偏激
一蓑烟雨任平生at : 就差指着日本[日本]的鼻子骂你要点碧莲行不 闲吃萝卜淡操心
-ZHIHENG : 中国这次很硬气[中国]
褐瞳wq : 感觉[中国]外交越发硬气了[good][good][good]
爱chok的源 : 气质好赞
Memories1314n : 回复@唐朵兰 的赞:亲，可以帮忙转发一下吗，十分感谢！
XiAo白兔奶糖 : 隔壁老王真棒[鼓掌][鼓掌]
maggie小娇 : 潜台词就是 nmgb的 在装B 就g你
独白-Jasmine : 高冷男神
冷-冷-碎 : 回复@WilliamWallac:可惜了，你们失了独立思考能力。
提灯照河山qiao : 日本就像个狗皮膏药，揭不下来，烦死了[斜眼]
蓝瓷X : 没完没了哈哈哈哈哈哈哈哈@磨牙大王 
爱幽蓝79297 : 回复@中华联合省合众国总统办公室顾问:所以媒体新闻自由就是想问啥问啥，不用考虑新闻以事实为依据？
洒满花影的西厢月落无声 : 男神，大写的帅[爱你]
Hascorgi : 感觉就是因为王部长在日本留学过，所以日本人到底是怎么想的肯定知道
捂到嘴巴儿笑 : 王总，弄它
李晓会SuperLee : 王大大的意思就是别他妈给脸不要脸[拜拜]
你是我心里的毒 : 我男神
请叫我韩晃晃儿baby : 男神就是男神
kjk_czz : 别没完没了！
山色空蒙112 : 又帅了，三天四会要注意休息[doge][doge]
郭峰磊 : 说白了总结成一句话：我们的事，管你屁事[拜拜]
境界一一掌门人 : [doge][doge][doge]我奉劝王毅不要太帅 太帅会死人的
WilliamWallac : 回复@冷-冷-碎:必定是外长。
陈丹虹_ : 没完没了了小日本
HYJ-Seven : 日本狗狗带
不二远方 : 超帅[色]
靠靠猫 : 日本你是逼逼机吗？就你话多，有中国的地方永远要来插一脚，附属国的身份你自己都不想摆脱也怨不得别人[拜拜]
南衷 : 没完没了莫名戳中了我的萌点[眼泪] [眼泪] [眼泪] [doge][doge][doge][doge]就像跟儿子吵架的时候说你他妈再错爸爸打的你找不着北一样
屁屁醒了 : 回复@孙喵喵还是孙猫猫:另外，我现在的生活一定比你好。我也感激国家强盛，可并不代表这个国家很好。至少，一个不能说呗的国家就绝对不值得欢呼。历史是需要进步的……
我是小天呐我是小天 : 我只想说，王部长我爱你一辈咂，真棒[good][good][good]
峨眉山黄婆婆 : 转发微博
零SMJ : 最近，出来Bigbang，好多妹子都迷上了wuli外长
大魏哥Lindan : 男神很强势
丽粒LiLiLi : 我要从为你的迷妹，男神[好喜欢][好喜欢][好喜欢]
提灯照河山qiao : 帅气！！！[兔子][兔子][兔子]
Eyoh_eyoh_eyoh_eyoh_eyoh : 我看见了我男神才进来评论加点赞的。还有日本你不要再惹我男神了、不然我们这些花痴不会放过你的[挖鼻]
M-mrs姜M : 拿下日本
爱幽蓝79297 : 回复@freetree2010:那以你说咋办，人家都找事到家门口了，还不要还击？
Support111 : 回复@中华联合省合众国总统办公室顾问:别一上来就讨论爱不爱国这个问题，也不要什么事都扣上爱国的帽子，究竟是什么原因也不是一面之辞就可以断定的。个中原委我们都不清楚，不是吗
Lucky_fzj : 帅气[鼓掌]
Ye_log : 求王外长视频
SHAPAOZIIIII : 男神
不知道叫什么llano : 我希望他能多活一百年
冷-冷-碎 : 回复@WilliamWallac:你们在二十一世纪搞这种带有欺骗性的舆论灌水丢人吗？
第十三生产队小牛 : 现在回复的僵尸号有很大进步，一般都是关注十来个官微号，几十个粉丝，十来条留言这样，回复的内容也不会像以前那么官腔，真正做到活泼互动又亲民，要点赞
一闪一闪也亮晶晶 : 国民男神王大大[好喜欢][好喜欢][好喜欢]
只剩亿点点 : 小日本鬼子[大便][大便][大便][大便]
木_-也 : 
哼哼哈嘿710 : 王部，我也是您的脑残粉[害羞]
Dorothy_权 : [good][good][good]
xxxrika : 表白王毅[酷]
Hello-kadn : 男神就是帅
闪闪羊i : 我男神就是帅！
弱水一朴 : 祖国这么直白 赞！[心][心]
WilliamWallac : 回复@冷-冷-碎:他是我国外长，必定有他的我长处。慢慢看吧[开心]
韩小秀 : 我单方面仲裁这是我爸
Cao丶Fuck : 回复@Berry-be:臭不要脸[doge][doge]
_冯冯冯冯冯_ : 回复@不一样的男士:我们中国秦朝是日本人的祖宗 这可不能随便操的。
J-spaces : 秒杀
安东麦 : 吴先生们对王毅是恨之入骨的，不过我们喜欢王外长。国际政治，有时候不但是五项原则基础上的睦邻，而且还要有斗争的勇气和智慧。一些问题上要会耍“流氓”，“流氓”政治是对付霸权的必要手段。
家村叫我来巡山 : 我感觉部长分分钟憋不住要骂出来了[doge]
许若相依 : 请美帝的走狗不要出现，网络是个可怕的东西
安冬尼的小王子 : 回复@中华联合省合众国总统办公室顾问:请您发个链接[微笑] 我也乐意也愿意去查
WilliamWallac : 回复@冷-冷-碎:这个我无言以对。
屁屁醒了 : 回复@孙喵喵还是孙猫猫:我是该夸你热爱祖国吗，生活是好了，这就代表国家很好吗！美航母到家门口而没有打就在那欢呼。那为什么美航母敢到家门口呢！日本解禁自卫权、韩国部署萨德、菲律宾坐滩黄岩岛，别忘了，历史上无论唐宋元明清哪一代不曾盛世！最后呢……不是所有评论都叫键盘侠，同样的，一味歌颂的也许连键盘侠还不如！
承姬欧尼撒浪嘿 : 日本怎么还不去日[doge] 本人
红尘小妖爱GD : 王毅：在JB乱BB，嘴给你撕烂 安倍：嗨
蒋黎雨 : 回复@中华联合省合众国总统办公室顾问:加拿大应该懂得：他们记者有提问自由，我们部长也有反驳的自由，言论自由是双方的
灿的老窝 : 偶像来了，没有废话，点赞转发
wo是A型血 : 转发微博
大大inging : [赞]
文子啊李子 : 站队最帅天团～
大睿宝刘刘刘 : 帅
海蓝透_ : [兔子]
kv-nelly : 说的好
伍伍说不要 : 嘤～男神啊！
大前雷子 : 再bb分分钟把你变成日本省@Rie_Tanaka
抱個兔 : 日本你不要搞事情我跟你讲 我疯起来连我自己都打！
我爱竖直的木棍 : 就是这么有尿性，我骄傲了吗？
我是大爷爷爷 : [good][good]
一半柠檬一半不萌 : 全民男神！
我是大爷爷爷 : 帅！
冷-冷-碎 : 回复@WilliamWallac:外交很失败，所以要靠你们这些小紅粉集体捧场，此地无银三百两！
_枸杞菊花当归人参 : 中国[中国]：我是不是给你脸了？？？
爱吃橙子的吃货 : 男神太帅了[good][good][good]
会发光R : “卖av的，门在那边”
中华联合省合众国总统办公室顾问 : 回复@安冬尼的小王子:无知不是你的本钱，自己查去。
浅若夏沫曦 : 日本跟你有什么关系
第十三生产队小牛 : 回复@RilkeanHeart7:这又大大 那又大大，你得有几个爹啊？！
邻居老王不爬墙 : 看见男神了
萧森与佩佩 : 有部长处必有我!!
刘大月子 : 我男神
Sonnenblume-f : 回复@源氏物語110:民国亡了[微笑]小可爱
中华联合省合众国总统办公室顾问 : 回复@Support111:不是国家利益吗？这个时候你怎么就这么不爱国了？
想网名太麻烦了 : 真男神，我天朝外长霸气啊[爱你][爱你]
安冬尼的小王子 : 回复@中华联合省合众国总统办公室顾问:呵呵  看您微博名称，就知道此事空穴来风[微笑]
HuaXrui : 牛逼
老谭我是你的酸菜呀 : 王外长有孙子吗，想嫁
她说风儿也睡觉了 : 我宣布，这个霸气帅气的男人是我偶像！
妮妮233万花筒 : 外长好帅!
血龙卒 : 日本鬼子亡我之心不死。国人还乐呵呵的去旅游给人家送战略物资呢，日本来中国旅游的减半，我们去日本的却翻倍，这也许也是一种差距吧。
Sonnenblume-f : 回复@草莓莓草莓草莓:建议别和台独说话[害羞]他们都是小可爱伤不起[微笑]
微尘_PXX : 真是的，没完没了
夏殇儿喵呜 : 赞[威武]
红豆阿辰丶 : 帅
__Doki : 有这样的外交部长 就可以放心了[鼓掌]
-誅誅88308 : [赞][赞][赞][爱心]
-VSnow- : 霸气 我大中国男神[good][good][good]
糯米婆 : 回复@源氏物語110:我真的为你的幼稚感到悲哀，如果你是真的幼稚，我真心劝你多看看世界多看书。如果你是假装幼稚，那也真心劝你，回头是岸。
北京西城健康教育 : 解气
蒲苇丝丝很好吃 : 不知道翻译能不能翻译出这句话背后的“智障 少tmbb”
北京西城健康教育 : 不知道咋说好了
Support111 : 回复@中华联合省合众国总统办公室顾问:所以涉及到了你的利益？
载得晚小姐 : 其实中国前任外交部长更牛逼，脾气那个爆啊，直接来句，你说什么呢，你跟谁说话呢？太吊了
阿呆和阿瓜Oo : 真帅！[心]
源氏物語110 : 回复@草莓莓草莓草莓:中華人民共和國想侵略中華民國，錯了嗎?
李家大小姐Lee : 就该强硬
冷-冷-碎 : 回复@WilliamWallac:他在加拿大表现得就像个混混。
叶岩_Venus : 加油
奋斗青年败笔 : 日本人真贱，没完了还
蘇靌寶sunshine : 自身难保还多管闲事！又想挨揍了？[打脸]
老谭我是你的酸菜呀 : 想去外交部蹲点看外长[害羞]
倾姗依舊丶 : 赞的我手疼[doge][doge]
中华联合省合众国总统办公室顾问 : 回复@言小溯的微博:加拿大说了因为某外长干预他们国内媒体的新闻自由，重新考虑跟我国的贸易协定了，无限期搁置。
destiny-坎坷 : 帅
深爱娜姐的我 : #外长王毅##我们引以为傲的帅气外长#[心][心][心][心][心][爱你][爱你][爱你][爱你][爱你]#只有一个中国##中国一点都不能少#
我已经萌成一个包了 : 真帅
QQQinzihan : 这很中国！[心]
倩姑娘666 : 说得好！！！[作揖][作揖]
Gyh有魔法能量瓶 : 帅气[爱你]
用户5942337866 : 赞[good]
QIer977 : [鼓掌]男神好帅
说好的厮守一生 : 不要一错再错！
权少女a : 让小日本瞧瞧咱男神的王之蔑视
小鱼妹妹小玥 : 小日本就是欠收拾。
二月红眉笔代购 : 是的 不要搞事情[哆啦A梦微笑]
RoseElla蔚 : @ManjusakaCrystal @h2yh
凡凡de小妮子 : 大写的帅[good]
言小溯的微博 : 回复@中华联合省合众国总统办公室顾问:加拿大求的我们[挖鼻]
宁西熠 : 王大大威武🙈
让我一个人安静安静 : 给霸气的王毅部长点赞，支持！
爱做梦的大恐龙 : 我想知道日方是如何回答的
小雪丶Snow : 男神帅气！
光阴online : 敦促中方不要一忍再忍
love丁香结 : 男神说得对！
时间不老爱已荒凉 : 爸爸还没说话，儿子怎么屁话那么多
妇联委员会主任 : 男神
Memories1314n : 我家位于北京市房山区青龙湖镇辛开口村，721时大雨进屋，房后铁路无排水措施，雨水流到房后导致房后道路坍塌，地基被水泡下沉产生大裂缝。与铁路局协商、打官司他们官官相护。这几日的大雨7月24日凌晨两点房塌，今天打了防汛指挥部门电话没有回应，不知应找哪解决，希望大家帮忙转发微博找相关部门解决
坐等护宝小分队逆袭 : 没完没了，小人做派，不理人你还蹦哒开了
雷妹子阿 : 没强硬的时候说太软弱，强硬了就说到处树敌，呵呵[微笑]
手机用户3033044122 : 日本和美国是最欠揍的两个国家，尤其是美国无比欠揍，日本奴才一个跟在美国后面，美国人的狗
g假发 : 霸气
阿三古7286 : 小日本就是美帝的搅屎棍。
何七一_ : 迷妹在这[羞嗒嗒][羞嗒嗒][拜拜]
中华联合省合众国总统办公室顾问 : 请问，因为某外长一句话丢失的加拿大贸易协定，这个损失谁来赔？
罗佳Loga : 就是就是，外交部长最帅了[爱你][爱你][爱你]
荒芜青木- : 没完没了的奉劝。
村长夫人1985 : 再叫把你日方！
旧城南思- : 一直觉得王毅大大很霸气！
呆萌释宝宝 : 如今的外交官应该是近现代以来最帅气的！赞！[good][good][good]
WilliamWallac : 回复@冷-冷-碎:他的内心是帅的，所以脸不重要。不知道爱屋及乌吗？喜欢一个人的内心或是他的某种品质，他的气质在，所以形象当然是帅的。（这是我的观点，您看呢？）
自恋的七七啊 : 王毅部长帅呆了
专业代购瓜子 : @不知哪块小饼干 大写的帅气
羅布zhaxi : 霸气 我都想跟你么么哒了！[鲜花][哈哈]
Moon_Rover : 对牛弹琴
kiki-唐芳芳儿 : 真的搞不懂有些人怎么想的，老说我们打嘴仗，你厉害你上啊！以为打仗不影响我们自己的经济吗？还嫌外交部太强硬，不给日本话语权，真搞笑，自己家的事凭什么要听不怀好意的外人说三道四！支持王部长！！
張在型 : 最帅的一张脸了[喵喵]
呜咧 : 男神!
瓯江源头-金 : 该给小日本点教训
Y霸气范Y : 霸气，我喜欢
CH_XININ : 帅就一个字，我只说一次。 …不，我还会再说的[笑cry]
最无法预见的是遇见_Z : 这霸气[doge][doge]
NCR的农村人 : 现在看来当初那俩原子弹真没扔错，就是少了
dengchunge : 说话越来越硬气，好！
CM阿迪 : 别特么再没完没了了！
freetree2010 : 不得不说，到处树敌，外交很失败
亞麻色_貓 : 太帅了，太给中国长脸了
四夕口月鸟 : 王之蔑视
乾坤赤 : 自古以来，日本都是煽风点火的急先锋，改不了了。以后要教训教训它
如墨浅渊 : 表白男神~(≧▽≦)/~
ohBaby由 : 王叔叔最帅气[喵喵]
Bystander静 : 可以 王毅帅呆了
D啦AA梦_时光机 : 求视频
一地鸡毛ufo : 回复@LJ-ZZOO:公示尼玛个蛋呢，他斥责你爹了？
有一点儿可爱 : 喜欢王毅大大的才能赞我[噢耶][噢耶]
斗转星移之风云突变 : 日方早已错到 无药可救，回天乏术的地步，甚至走火入魔的境界。所以，劝，只是一次又一次的浪费口水。对日本这类贱骨头，就是要来点硬的。
Kennyccyu : 勿谓言之不预也
Oly刘洋 : 弱国无外交，外长早生个几十年，什么八国联军小日本也不会那么嚣张！
绿之芽 : 转发微博
vinegar_汐 : 要打就打，别那么多废话
阿歪喜欢蓝天白云 : 部长威武～
形随心动自在而活 : 外长并不想理你，抛去一个蔑视的眼神，挑事的人自行体会[拜拜]
宇宙无敌炒鸡腻害萌萌哒林少奶奶 : 热评有人说要王外长公布财产？？？exm？这个转进我给零分
沙河豆浆店618339044 : 该战就战吧？中国人民支持
TODAY20160406 : 呵呵，中国人“奉劝”了世界各国亿万次了吧？
笑鑫_ : 男神！
深水藏光 : 咱们不要老是说要国家去制裁日本，如果咱们少去日本旅游，少去日本整容，少去日本嫖妓，少买日货，看看小鬼子还有没有那么多钱来暗中挑事？
gc某年某月某日 : 给个眼神让小日本自己体会[微笑]
福17777388549 : 大家一起抵制日货，
吴吴吴吴吴吴三贵 : 回复@Berry-be:姐姐你好[挖鼻][挖鼻]
洁雅洁雅_T : 就这样说说而已，日本不会听话的
临清市乐佳保温有限公司 : 据理力争！
爱拼才会赢80952 : 回复@没有爱过你LL:你还是太年轻[害羞]
惟爱易帝 : 霸气男神[可爱]
若邪兮 : 帅哦
不上岸誓不改名 : @大瑶哥哥智能护肤商行
自是思量渠不与-人间总被思量误 : 王外长对于批判日本的一言一行，小日本都得掂量掂量自己，驻日十年，真不知道你小日本到底几斤几两！
我的偶像吴尊 : 王叔叔好样的，威武
程艳蕊 : 别以为咱们大中国会任人宰割
前排2块5出售弟弟 : 帅气！
-只傻瓜r : 王毅是我们的男神！！！
青柠_1573 : 男神！！！！？
无奈不懂心中事 : 日本 就不能乖一点吗？ 老这么跳 要是真的打你 你可不要哭
夏娃的肋骨回来了 : 一句话：关你p事，给爸爸闭嘴[doge]
未来昔日 : 嘴遁……中国人民都听腻了
大林坊 : 见你，只是为了警告你！
寄信给森林 : 真的长志气！！！
爱因斯坦Albert-Einstein : 把日本收拾一下，美国也后腿三步
咩咩a小牛 : 回复@捉鸡逗逼:哈哈哈哈
时尚手机说 : 无论从历史因素还是民族情感，我大中华最想打日本，，，，，认同的点赞
用户5521710842 : 小日本儿就是欠揍，谁打它，它就服谁。
Yolanda_Tsia : 霸气～男神[心][心][心]
穿梭时间的cyf : 男神说了这么多，日本人估计也很迷糊，我来总结一下意思：艹你妈！
kent晨 : 中日两国互相仇视妥妥的
贤TG : 回复@我有一个仙女棒O:妹子咋知道那么多？[哈哈]
海燕燕燕mhy : [good][good][good]
嘟嘟的风0 : 赶上张将军了
jhuang : 日本他就是这样了。还没没皮没脸。并且谨防小日本偷袭。
Skm自然醒 : [doge]别没完没了知道了不
夏日晴空abc : 小日本 爸爸家的事你少掺和
没有爱过你LL : 那些说中国外交失败的！柬埔寨巴基斯坦和中国的友谊你看不到？菲律宾不敢再bb南海仲裁你看不到？之前南海仲裁那么多国家支持中国你看不到？至于美国和日本  就像恶狗一样  没办法跟它友好相处  但是中国外交从不惧怕  已经警告了日本  你还要怎样？你要是觉得别人不行  you can you up 啊[doge]
心里藏着一片蔚蓝 : 霸气
不一样的男士 : 操小日本祖宗！
钱钱去南海 : 王毅手指：来，日本的从这边滚出去[doge]
翟海琦_ : 干他 他妈的 日本鬼子
赤焰少帅夫人 : 再加一个招牌白眼就完美了
安崇民 : 别指望日本自觉自守，它自以为不跟美国咬中国，就没啥活路……![衰]
优小偌 : 帅[色]
轩轩5547797030 : 男神
像风筝寻一个梦11 : 王之蔑视！
狮子座小奇 : 牛逼
ELF的宝蓝盛世 : 真正的男神好帅
Tracy宅 : 帅！
我就是Tito : 中国可以在琉球独立，南千岛群岛，独岛，冲之鸟礁等方面开辟第二战场，让这些杂碎顾头顾不了腚
cooplw : 大大涨粉[兔子]
Lange_HL : 回复@源氏物語110:那我也告诉你，南海仲裁根本就不是法律问题，而且政治问题，是美日联合的阴谋。台湾和大陆是唇亡齿寒，别巴着你的美国爸爸，他根本就不会让台湾发展起来！
李家海参铺子 : 就算他们没完没了，又能怎样？继续谴责呗？
Mongel嘎嘎 : 十个全覆盖，全靠涂料盖。泥墙摸洋灰，谎报危房全新盖，国道两边放光辉。偏远乡村貌不改，夸大工程向上吹，欺上瞒下捞油水，地方财政都在亏，卡扣挪用各种费。百姓根本没实惠。口号喊着反腐败，吃玩的地方不挂牌。可怜中央费苦心，老虎苍蝇遍地飞。
Candy奚奚 : 我男神，真爱男神，就是一直这么帅气
IFYOU--------- : 瞬间迷妹
语诙 : 心中的男神[赞]
喜欢后面姓蒋的女孩 : 门在那边
PRAHAZUN : 新晋国民男神
怕热的胖子ccc : 你一个拍av的不要说话[哼]
Zzeo-张宇 : 话语太强硬？不会外交？你tmd觉得能和一个白痴说请你有礼貌些？有病吧 看不上咱国家的外交部长你滚出去啊 去别的国家啊 看有没有拦住你 话说人别的国家还不要你呢
A-FlowerGirl : 现在的新闻比脑残剧好看多了[汗]
吉松喵喵 : 不得不说，这个老头，我喜欢……相当帅气，有魄力，敢于说话……支持你，我新的男神……
黄大玥 : 霸气
Guiltyyyi : 感兴趣的看一下哦！
jin逸28 : 迷上，男神！
Helena-shan : @万牛牛w
手机用户2377346363 : 我警告你，小心新账旧账一起算了，
xiaochaomt : [doge]
素久llw : 我男神王毅什么时候开微博
某站丶 : 男神
我不告诉你618 : 我就喜欢王毅大大的表情
echo2401 : 没完没了
Limo丽 : 男神[心]
谈谈看_BLUECD : 给脸不要脸
素久llw : 看见男神我就进来了
笑死-你丫的 : 日方.我特么就没完没了...你能把我咋滴...[挖鼻]
喵喵5889753992 : 赞，一百个赞
MiaoYanghappiness : 外长说[哼]：看你个样，观音的南海你也敢抢，你[怒]咋不上天尼？
orange997 : 日本就是不要你脸
突然之间不想用昵称了 : 上次看了你的那个短视频，你就是男神[good][good]
啊文靜9 : 男神[色]
江小盐_Tzwx : 手势：门口左转，走好不送
轩轩5547797030 : 回复@源氏物語110:完整的看一遍整个事件好吗，不关他的事？关大了兄弟
渔儿-贺兰悠 : 我是王部长的迷妹[得意地笑][得意地笑][得意地笑]
澄农夏末 : 说的好
我叫敏小杨 : 我男神有勇有谋！[爱你][爱你]
行禅l : 王外长，请收下我的膝盖
马------晓晓------宁 : 回复@说NO的小王:个人见解：只能说他赶上了这些事，并不能说他没有能力吧，而且不觉得 他对外回应特别强硬吗？
如可分身饰演自己me : 没完没了还，给你惯的？
-陳彦孜 : 男神[太开心]
Brownrat : [心][心][心]
用户06110718 : 日本跟中国难免再一战   这次一定要让日本亡国   干它（日本鬼子）
顾爱顾爱 : 帅死了！
Mobanche-十二 : “不要一错再错，没完没了。”这句话好赞[强]！咱老王就是这么有魅力！
房昀其 : 大国风范，意思就是，别特么给你脸还不要脸了
-by开心果 : 男神，好帅好霸气[抓狂]
小姚_LL : 看见男神就点进来了
瑶光zyj : 帅，，，，呆，，，，
阳光洒满1 : 好有礼貌
一只小小的腐女纸 : 王毅，男神！好帅！[心]
一只多肉姜 : 小日本真是补药碧莲[打脸]
DL南山樵夫 : 中国人就不能惯日本人毛病！
火丢丢_Sissi : 王之蔑视[good][good][good]
大大大大的大 : 回复@风扯鱼 的赞:[微笑]
xuhe84 : 回复@说NO的小王:有一定道理，再看吧……
造化为庸人设计 : 打你个倭寇稀八烂@人民日报 [强壮][强壮][强壮]
墨尘V渊V : 毅哥长的就霸气[哈哈]
混蛋一样 : 一个字“帅”
池塘水满雨停 : 心疼外交部长
杨厅Gert : 倭寇滚粗
我爱冰岛冰岛爱我 : 卖av的出去
六月烟雨江南 : 大哥
sparklive : 脸这种东西，我希望日本有，以及其他那些国家[微笑]
伯纳乌的冰美式7 : 没完没了[笑cry]好帅[哈哈]
是不是只有打一串数字才不会被占 : 别吵吵，正看我饭的天团队长呢，我爱豆就是不一样!
靡荼归来 : 王家风范[爱你][爱你]
说NO的小王 : 回复@马------晓晓------宁:好在哪里？韩国部署萨德，朝鲜发核弹，南海四面楚歌，台湾独派上台
Zhengshun刘正顺 : 说的太棒了
草莓味的糖ee : 就是，别她妈给我没完没了[怒骂]
melody-ruby : 那现在还是有好多人去日本旅游啊，这些人都是怎么想的？
静思广闻中 : 不用理来它！还又应约见面？
胖妞儿哎 : 霸气的男神啊
爱吃大餐的螃蟹ZYY : 帅气
吴周求 : 有用吗
五星聚 : [话筒][话筒][话筒]
CHENXIAOMIN1997 : 小日本戏真多[拜拜]
张木头不是木头 : 回复@LJ-ZZOO:别在这BB
拉拉的寻人启事 : [good]
萌萌的致列偶吧 : 霸气十足[强]
我爱诺一我会说 : 没完没了！
天地之间爷最帅 : 老王家人太帅[doge]
-卡布奇诺YY : 太帅！
WuPX : [心][心][心][色]
Lucky宋小花 : 看见祖国的态度如此强硬，真的很感动！[心][中国]
__Amor暮光晗笑 : 意思是你再逼逼 爸爸要打你了[微笑] 霸气
老衲不要去取经 : 男神又出击了
南城栀梦937 : 别逼爸爸出手[拜拜]
mwkalainen : 回复@说NO的小王:说得你好像很懂一样，我可以嘲笑你吗[拜拜]
铃儿响叮当加油 : 大大的赞
鲨鱼安东尼 : 喜欢毅哥的干净利落简单明了[心]
zxycom : 错就是错，还奉劝什么？奉劝有用早都闭嘴了，敢不敢打啊
阳光财险555 : 团团正义！！#问责云昆政府# 云南政府欺下瞒上，给党和国家公信力抹黑！泛亚事件是政府红头文件、央视新闻、国家统计局、16家银行、新华社、国务院参事、经济学家等联合的，合伙骗了老百姓430亿！老百姓无错无责！我们绝不为政府过错买单！@思想火炬@共青团中央:[话筒]@共青团中央:[话筒]
Juliet070 : 就是因为当年日本福岛核电站泄漏，污染了海水，空气，人类的地球受到了严重的打击。所以说，日本污染了世界的环境都不为过。
欣欣欣欣欣女人 : @活de像一句废话
大大大大的大 : 翻译过来：操你妈！有完没完！
RM-Smilodon : 安倍想火中取栗，日本侵略中国的贼心不灭。
我会改变靠意志 : 倭奴什么的开心就好 毕竟自带狗粮也不容易 就让它吠吧 不然一点存在感都没！
心随已愿言之命至 : 奉劝日本不要犯贱
瘾-peace : 男神!霸气[赞]
奶茶害怕过期 : 我真想给巴掌日本人，日他本人的狗
只是_F白菜 : 真tm帅
Langweilig彡 : 一个没脑子的部长，为我国外交捉急，长得帅可以去当演员，中国这一圈邻居没一个是友好的了，别看他说啥，看看结果吧
顾城之南 : 看到王外长#中国外交部长王毅#上热搜果断转一波[害羞][害羞]
说NO的小王 : 回复@xuhe84:话说的很硬，然而真正的成绩有多少，现在四面楚歌，真牛是能解决事情，而不是事情发生了在发嘴炮。
劉櫪雯 : 小孩太调皮了
只有黄的咸鸭蛋 : 说的好 但是光说不练假把式
云风飞杨-i : 还真是唠唠叨叨、没完没了啦！[挖鼻]用口头功夫就能赢日本啰？[吐]
不伤人的_刺猬 : 别和他们逼逼了，该说的都说了，让他们参考之前的发言就可以了。
马------晓晓------宁 : 回复@说NO的小王:怎么差了？不挺好的吗
花锦天下 : 预感，没完没了，会火！王毅大大帅帅帅[好爱哦][好爱哦][好爱哦]
闹啥子呢嘞 : 这就是传说中的王者风范
三年赌个未来 : 部长威武！！[拳头][拳头][拳头]
爱吃饭饭睡觉觉的少女 : 霸气
高懒懒丶 : 就问你小日本怕不怕
-香香小公主 : 男团威武
takeshiluan : 没完没了的，一定要往死里收拾，给脸不要脸的，无需再给脸。
东海龙王红孩儿 : 觉得王毅大大是理想型的赞我
淼淼的沐沐 : 霸气，对待搅局的狗日本就要这样霸气！[强壮][强壮][强壮][给力][给力][给力]
R_winter : 快成王部长脑残粉了[doge]
呉小吴乄 : 我男神[嘻嘻][赞][赞]
kitty不是猫i : @知事躬行 我男神就是霸气[色]
思敏思敏思密达 : 回复@不可治愈的重度拖延症晚期患者:哈哈哈哈哈哈
Swardbeing : 回复@说NO的小王:你行你去啊 [喵喵]
xuhe84 : 回复@说NO的小王:为什么
AnnAn劉 : 说日本就忘了邢台，套路
千代珍妍 : 有一种臭不要脸叫&quot;日本”
22一零 : 早就该直说了
xuhe84 : 中国一直忍忍忍
蕊妮可 : 可不是嘛
牛理智不理智 : 男神
次蜜汁烤翅叭 : 王部长：没完没了 真是讨厌
说NO的小王 : 他是最差的一个外交部长，没有之一！
东海龙王红孩儿 : 外长大人我爱你[爱你]
安河ww : 小日本个事逼
路遇良人i : 回复@LJ-ZZOO:讲真，给你个机会让你贪你都不会贪
宗旭oppa : 王叔叔把意思就是爸爸的事爸爸解决，不用你管。
贵州联通 : 全民男神王外长[鲜花][鲜花][鲜花]
霓虹国的波渃波洛蜜 : 回复@LJ-ZZOO:你这唱的哪出[微笑]
Ray_05_ : 嘴炮第一名
宇家的小狐狸 : 王外长，我们国家的男神！
唐吉坷德-多佛朗明哥 : 就想知道。。。过几个月有多少中国人去日本送钱。。。让日本狗拿钱继续嚣张。。。
圆圆美得像朵flower : 我大帅 哈哈哈[笑cry][笑cry]
Sunshine-LLLLLLLLLLLL : 王毅是我干爹
雪山情缘 : “不光彩历史，沒完沒了……”'这样的话都上了，日本人脸皮够可以的。
要成为大神的Dandelion : 真当爸爸下不去手?[doge][doge]
夙闵and雨落 : 大挺
空竹00 : 部长帅
Z-Alisa520 : 王毅好帅，威武
智障的祖母 : 没完没了[哆啦A梦汗]
枚枚枚鱼 : 嗷，就是这么霸气
第六颗星7 : 新一代的男神[good]
布瓜的世界呀呀呀 : 回复@取不出名字啊呀:是的！ [眼泪] 然后被口水淹死了
冷-冷-碎 : 一群苍蝇。[吐][吐][吐][吐][吐][吐][吐][吐][吐][吐][吐][吐][吐][吐][吐][吐][吐][吐][吐][吐][吐][吐][吐]
STHG豪_圣 : 我看南海仲裁案以来，新闻上经常讨论，我就想说:对一些狗[狗] 多说无益，并不需要跟它国讨论本国的领土，本来就是自己的，干嘛要跟别人证明自己的地方是自己地方。自己国家的地盘还轮不到某些狗[狗] 国指手画脚。
烂笔头666 : 回复@麋鹿gained:我觉得也是，狼还有血腥呢，那只能把日本比喻成一坨屎，说日本像任何不是人的动物，都可能侮辱了动物的名誉。
解放东路走玖遍 : 说吧，哪天开始抵制日货？[doge]
mm末小雪 : 回复@稻米mi1314:不知道，反正他的观点看完简直了，还是一个东北大学的历史系教授说的话。
扣脚跟女孩儿 : 好酷啊，要爱上你了
你最可爱dongyao : 就喜欢这霸气范[good][good][good]
彡莫逆 : 就是！有完没完！跟个泼妇一样！
沈星航dreamer : 奉劝鬼子不要没完没了[doge]
就叫董昊 : 回复@源氏物語110:你对日本这么忠诚，你的日本二爹道麽？国家领土不容别国说三道四。还有，台湾自古以来也是中国的一部分。别妄想搞独立[微笑]大陆一直没动手打你们这帮台独主要是还有想要回归大陆的同胞。你哪天真的敢独立一个试试？真的以为美国干爹照的住？
云云爱上等 : 给外交部长点个大大的赞[强]
素晨曦朝 : 我们的外长就是男神
一个咖喱杀手 : 迷妹卡！
取不出名字啊呀 : 回复@布瓜的世界呀呀呀:亲！！！
阿May____ : 部长不耐烦跟你说话[拜拜]
小熊爱小猫 : 王大大不高兴了 没完没了都讲出来了马上就要动手了我跟你讲 为什么我知道？都这是小时候挨揍的预兆[拜拜]
小小沈公子 : 再没完没了，小心我王外长帅死你
winteremma0105 : 手指的方向，出去！
丿SeoHyun丶Hala : 被圈养了辣么多年，不觉得它有最终决定权
根正苗红的社会主义接班人婷哥 : 别蹬鼻子上脸没完没了！！！
顾城之南 : 看见王外长#外长王毅#上热搜果断转一波[害羞][害羞]
我要干净舒适的生活 : 霸气[good]
only-阿连 : 回复@冷-冷-碎:有病[微笑]
That1978 : 帅帅帅[鼓掌][鼓掌][鼓掌]
青黎居士- : 小日本你操你祖宗，你妈类个逼，你那什么，你滚！反正就是得滚，气死宝宝了[泪]
酷癌少女ki : 可以，这很强势[doge]
张张张张张张婧 : 就要那么硬气
布瓜的世界呀呀呀 : 回复@取不出名字啊呀:我才看到，说有人亲了GD一口，啊啊啊啊
撩妹高手吴亦凡 : 新偶像
XN今心因心 : [强]🏻
谁是万金山 : 我男神告诉你消比听的[doge]小鬼子！
冷-冷-碎 : 回复@only-阿连:蠢货！
渏琨 : 毅哥哥   哈哈哈哈  不管  就是我男神[花痴]
Edelweiss-离殇boy : 太有气势了，[good]
花儿小姐姐 : 小日本别惹我男神生气[哼]
悠悠无定顿悟了无 : 6666
吾知你既 : 大赞！！说得太好！！！[挤眼][挤眼][挤眼]
小浩爱吃西瓜 : 脑补一下外长说别没完没了的样子，就觉得好可爱！
隔壁王先森13 : 就是这么有气势，日本狗，来咬我
燕窝--佘 : 你帅，你说的都对！
稻米mi1314 : 回复@mm末小雪:日本史的吧
李翠娟L : 看我墙头来的！
Zoe留下 : 男神说的对啊
CH_XININ : 帅就一个字，我只说一次。 …不，我还会再说的[笑cry]
大大大大大姨妈妈- : 帅到爆炸
only-阿连 : 回复@冷-冷-碎:我去，不要回复我了
Vanessac13 : [哈哈]好Q萌的圆脸
浮生若梦U半夏如烟 : 真的霸气
晨曦來臨沛精神 : 王毅部長的手勢意思就是說:小日本 只要妳敢一錯再錯 沒完沒了 最終 只有死路一條
霍霍西i : 就这么霸气
沐洋201602 : 很喜欢王毅发言大快人心
热吻Oasis : 躲过了韩流明星躲不过王毅[爱你]
萨拉热窝MP5路 : 真 男神
赖琼琼__ : 男神王毅[爱你]
小布丁要趁热吃丶 : 日本，请出去[拳头][拳头]
村妹Suyi : 主要来看男神的....
艾折腾 : 帅
mayday_Zoe : 看见男神就进来了。[飞吻]没错，立场问题，不可含糊
冷月的宝盒 : 琉球独立
ambersitar : 记住了你了我的偶像王毅:经典名言，小日本不要没完没了，靠边站
拥抱太阳的向日葵迷恋蒲公英 : 男神
麋鹿gained : 回复@烂笔头666:你这是在侮辱狼啊[眼泪][眼泪]
紫藤若曦_16452 : 日本你给我出去
李荷花啊 : 威武霸气[good]
用户tfarxtsaxg : 帅 霸气男人 我喜欢[害羞]
锬雷楙 : 回复@源氏物語110:台湾省的一边玩去，大陆爸爸懒得收拾你们
萝莉扣字手 : 新晋国民男神[爱你]
我会好好的ccccc : 我偶像
文刀长弓 : 就故意错，你拿我小日本也没办法，气死你们中国
西凉儿 : 我们外交部长虽然是学日语的，但并不亲日[doge][doge][doge]就是怕你们听不懂英文才要好好用日语说给你们听[doge]
Amaro-嗳柯 : 男神
心愿半梦 : 威武霸气
ambersitar : 帅，王毅，我记住你了，偶像
_ZHyuAn : 王毅酷毙了[愛你]
mm末小雪 : 今天还看到一个历史教授说王外长不应该这样说话，简直让我三观都碎了，说不能剥夺日本人的话语权。呵呵了
咿呀咿呀菜 : 男神
清漪慕晗 : [心]
依見妳就惠笑西西 : [good][good]
田小静Toney : 看看我们王外长这颜值。你们没我们颜值高的某国就别嘚瑟了
Cookie_jia : 男神霸气[爱你]
FANTASTIC_XIN : 王外长好帅[爱你]
硕欧巴v : 是时候了
梦想家天空蓝2016 : 男神[嘻嘻]
忘我心安57 : 日本，闹够了没有？？回家多读点书吧。[斜眼]
记忆有点胖 : 干得漂亮
都暻秀咻羞挖敲害羞 : 没完没了[笑cry][笑cry][笑cry][笑cry]
晶茗aquarius : 说没完没了就代表很生气了哈哈哈
不辣的皮特2022 : 看话里的意思，是已经跟猴子国和解了？[思考][思考][思考]
欧肉肉oh : 没完没了，中国懒得理你
LeeX尛X尛 : 男神说的对，坚决拥护男神！
爸爸妈妈的琼琳 : 我们的祖国
不足为奇之辈 : 生活除了眼前的苟且，还有将来的苟且，无穷无尽。。。。。。周而复始。。。。。。。
千树1126 : [强壮][强壮]
Knwu咸鱼 : woc好帅
MoLing菱 : 国民男神
许韫 : 一个字：帅[爱你][爱你][爱你]
濮阳-默訉 : 王毅粑粑就是这么霸气[爱你]
徐佳佳xi : 日本是明着来，韩国是暗地里来
byeby许教授 : 人权 我们的人权在那里
万里浮云无股也呻吟 : 曾经的驻日本国大使，如今的外长，北二外日语专业毕业，说得一口流利的日本语。要用日本语日日本人，更动听。
萌萌和米诺 : 霸气[心]
你是我拒绝别人的Liu : 外国人就特么赛脸！
only-阿连 : 回复@冷-冷-碎:难道公知有吗
杨学义01 : 回复@故城伊人情:1937年毛主席不在吗？
崔塔塔的鸡涌君 : 新晋男神[酷]
Jingyue苏 : 日本政府就不能换个玩法么？这一套都快玩吐了[doge]
寂静安然香香 : 就是這麼霸氣!
某见光死的爱黑发的坚定佐控 : 不要没完没了[微笑]
Adam的馒头 : 搞事情[眼泪]
JongSiYeon : 酷
tutu兔斯基 : 新偶像[嘻嘻][嘻嘻][嘻嘻]
xxxigd98- : 霸气
南7Ann : 霸气，
我听说昵称不能全是数字 : 局座[玫瑰][玫瑰]
地上一只鸭丶 : 我看日本这条疯狗没完没了
事儿事儿叭 : 一个字帅，二个字帅气，三个字太帅了
美美哒XY : 男神好帅
魏玮琳Watermelon : 我外长帅的不行[爱你]
luluwuwei888888 : 为了国家利益！
RENJING-- : 王毅大大好帅气
取不出名字啊呀 : 回复@布瓜的世界呀呀呀:li………
我看到似曾相识的场景 : 霸气
YC_haru : 霸气[坏笑]
长长倦倦_kc : 日本狗子越南猴子
d-cri豆子宝叨叨 : 外长[good][good][good]
Hi花样年华 : 外交部长告诉你哪儿凉快哪儿呆着去[挖鼻][挖鼻]
JessieL静 : 有点像狄龙，我不做大哥好多年[笑cry]
夏末苏罗 : 经过balabala…仲裁，宣布王毅大大是我干爹（菲律宾style）[拜拜]
Swiftyborn2 : 没完没了[doge]
烂笔头666 : 日本就是狼！
Shining-宝蓝 : [威武]
海格立斯2015 : 王部长意思：关你毛事，别逼逼
散峰789 : 日本🗾小虫子要被中国金鸡吃掉了[挖鼻]
手机用户2509153031 : 小日本开口谈南海扔下一句关你屁事，先解决好慰安妇问题再说!立马走人!
弦上的微笑 : 小日本，你一开&amp;青&amp;楼&amp;滴，有什么资格参与国家大事
璐女孩爱足球 : 男神好帅[doge][doge][doge]
Uniqueness-王 : 回复@ToPBoXLEo:好几年前就发现了
挖个大坑埋青春 : 真心帅
天意Yuen : 小日本好變態好下賤的，看我外長長得那麼帥那麼有魅力，就不停地騷擾我外長……我外長瞧到小鬼子的那副賤樣兒，生氣了：小鬼子，滾粗！你們很惡心，我們對你沒興趣，別沒完沒了的！[喵喵]
土方十四郎Hijikata : 配图:卖AV的滚出去
阿朔朔朔 : [笑cry]没 完 没 了
小螃蟹BOY : 王毅迷妹报道[拳头][拳头]太帅了！
一隻姓汪的喵咪 : 真的…好像林青霞！
骏哲勇士 : 日本管好自己，小心地震，哪里那么多事
布瓜的世界呀呀呀 : @取不出名字啊呀 圈粉圈粉
安非anfei : 岸田下个月就下台了
心情不太烫 : 我也姓王[微笑][拍照]
字典都被我翻出来了 : 别说日本首相日本政府日本发言人了。就是日本民众都像是太平洋警察似的，真以为自己世界管家？
初学者160628 : 回复@玉子成 的赞:谢谢！[给力][给力][握手][握手][咖啡][咖啡]
很偏执很任性 : 王部长很帅[good][good][good]
一条叫Alice_的鲸鱼_ : 真是 不要没完没了
ToPBoXLEo : 回复@Uniqueness-王:帅！
白泽的鬼灯大人 : 一个字，霸气！！！
lixy0225_leggo : 王毅霸气[瑜伽二]
__小月亮 : [good][good][good][good][good][good]
Aaron雅思要考7 : 男神：你还有完没完了，烦不烦啊[怒]
SHUMANCHE : 中国公民相信China Police？很可笑的问题吧？
贪财的金牛座 : 外交嘛，不是用来骂日本的，有本事让日本支持我们啊
断翅膀的木鸡 : 没有视频吗？好可惜，虽然能想象王毅的英姿煞爽和口气，但是还是想看看。
墨染旧辰 : 日本错的是整个民族，拒绝历史
我是求求呀 : 不行就打日本吧
周熙為 : 诶呀一切都是政治需要，一方演一方配合
厦门利易工贸有限公司 : 让懂中国人民的决心，
Redbobo_ : 王毅威武[威武][威武]
R-Amber : 帅
天天天天南 : 关它屁事。瞎鸡巴bb
股海禅风 : 王部长太酷了……[强][good][赞][威武][威武][威武]
J_COCOA_J : 我也是来看男神的。
桃妤姑娘名小应 : 大王厉害
Claudiawww : 我男神真帅[飞吻][飞吻][飞吻]
水坑銅錢 : 2字 帅气 还有2字 硬气
C靖J : 所以呢  日本吓死了吗  我们现在就会打嘴炮吗
下雨天我在踩水 : 长的萌萌的，有魅力，真正的男神
_蘅芜_ : 单方面宣布这是我家亲戚 ！
骑着小猪找CoCo : 帅气的我家老王
眠空farewell : 在哪可以看视频[思考]
Xmeng-瞎蒙 : 男神，可以开个微博吗？[色][色][色]
炎凉大爷 : 楼上那个，网友并没有说错嘛，菲律宾是卖香蕉的啊，日本AV很牛逼啊
奋斗斗豆腐 : 帅
远沙长鑫 : 曰本真这么听话还好了 光说不练假把式
adele7000 : 就是 没完没了！！！
YenJuan : 我大天朝第一美男子[微笑][害羞]
猫儿和家虎 : 我干爹生气了，后果很严重[哼]
黑发小卷毛 : 真的，日方快别没完没了了，我特么东西都准备好了我妈死活不让我去办日本的签证，无语了。
井宝775 : 孩子不听话，多半是惯的，腿打折就好了
gggjjjj2013 : 转发微博
被驯服的xiangx : 帅
阿润94721 : 对对对 烦死了 滚滚滚[挖鼻]
J_COCOA_J : 日本会来挑衅，说明他们不怕现在的我们，怕的是未来的我们;说明他们过于相信现在的自己，过于胆怯未知的未来。
初学者160628 : 回复@勇星俊 的赞:谢谢！[给力][给力][咖啡][咖啡]
故城伊人情 : 回复@杨学义01:时代不同，形势不一样了。毛主席要还在，他们也不敢叫嚣。。
嫚柈啪哋鉮遊鍺 : 好，说得好！[赞][赞][赞][赞]
棒棒爸爸2011 : 王毅刚当外长时没有这等气质 几年过去 气度爆表啊！
浅语smallcorner : 你若没完没了 我便寸步不让→_→
-赵冰儿 : 反正有王大大的我都赞[爱你][害羞]
obstinate29 : 王男神:妈的智障，你全家智障，艹！全岛国都是智障！
我想iIililillliii : @王外长粉丝团
4394nan : 哇[色]男神棒棒哒
我乐故我山 : 我也觉得部长大人霸气极了，面相吧，让我国和友国人民安心，让不友好国家畏惧
凤凰传奇De毅花 : 今天上语文课，老师也讲到了我国的外交部长，特别有“魅力”
草根世界观 : 有礼有节！
小仙女solia : 好帅[拳头]@以马内利M
纯洁的大眼睛 : 周恩来逝世以后，中国再也没出现强硬的外长。希望王毅外长真正强硬起来！
无人能敌的BIGBANG : 王之蔑视[坏笑]
还是根正苗红 : 男神欧巴～
唐JT_T : 这话眉没毛病
我胡汉三又回来了哇哈哈 : 日本真是找死
玲玲Jess : 大写的帅
电竞三丑是谁 : 这一届的外交部之强硬，全在前辈的累积，强，即正义。国与国就是如此
孙喵喵还是孙猫猫 : 回复@屁屁醒了:有些人从来不想从1949至今，民生改善了多少！如果没有祖国的大环境，你还有空做键盘侠！美国航母开到家门口了，大妈照样广场舞！真的，人要有良心，别自己过得不好就说国家不好！我只能这样说如果你说现在的中国不好，那现在没有好的国家了！[微笑][微笑][微笑][微笑]
大爷和大爷不是一个意思 : 脸上写着刚毅俩字
Ta的碎碎念 : 永远这么帅。[威武][威武][威武]
听说張付俪是个靓妞 : 中国网民太有才了，说菲律宾是卖水果的，又说日本是卖AV片的[嘻嘻][嘻嘻][嘻嘻]
SUJU韩庚V : 点赞
LRL-Lynn : 真·男神
莲xianger : 太帅！
凯始易兴玺欢大侄子 : 男神
Hia_Hia_这个昵称没人用 : 男神帅起来真没韩国那些欧巴什么事了
Chen-ruiyue : 回复@XXYangg_:说得好!
基因不会说谎 : 日本文化喜欢被虐，你越骂，它越爽。它是完全跪舔强权的。
启航远航_66923 : 小日本是个赖皮狗打它几下就乖了
爱大自然的小蚊子 : 男神~
学富八斗 : 要在经济上采取一些措施发出一些信号，外交部不能单打独斗。靠嘴是吓不住鬼子的。
逆水DE鱼oO : 人日自己玩自己，挺开心。
陌殤雨 : 小日本真是不要碧莲！！！
藏在心底的秘密000 : 没完没了一词很赞
Gemini-安好 : 就是这么帅炸
林姑娘的幸福大巴 : 日本不是南海争议的当事国，意思就是没你事儿你别瞎掺乎
龄茉 : 啊！王大大好帅！
外语民工吴师傅 : 劝你不要给我搞事[眼泪]
手机用户3155539850 : 我大中国就应该霸气[赞][赞]
教授很小心 : 有王毅大大做外交部长，跟这帮周边小国谈话，就像教育小孩子一样，沉稳、大气、有态度，这才是大国该有的外交态度吧，我中华崛起之时已经到来！！！
疯长的千屈菜 : 回复@LJ-ZZOO:公不公示也轮不到你来逼逼吧[微笑]别把自己龌龊肮脏的想法强加到别人身上[微笑]
CandiceeQ : 求前线高清图。帅的一逼。
谢巷深处在发声_ : 国家脑残粉来冒个泡[哈哈]
是太阳呢00 : 外长这表情简直帅炸[good][good][good]
诗苏叁叁 : 转需
醉笑往事如烟2007 : 王毅王毅天下无敌，，
向着阳光的花骨朵儿 : 霸气[中国]
莫忘初衷gm : 这是世界上我最烦的一个国家，没有之一。[弱][弱][弱]
WL的小世界 : 我想看这段视频~
我爱伊雯 : 日方：先撒泡尿自己照照镜子
古月丫头不发财天理难容 : @阿茜想欢欢 快看 男神好帅好霸气[太开心][太开心]
朝梦想迈进啊 : 男神[爱你]
哲欣哲欣 : “没完没了”这个词用的好！
Da_梦__ : 真是没完没了
我猜我和你都有一样的心情 : 日本一天没完没了B啰嗦就像老奶奶的裹脚布又臭又长[吐]
恭喜大王_贺喜大王 : 感觉是跟调皮的小孩谈话
_半醉半醒半浮生-- : 没完没了
Radella蕊 : 我们国家强硬一点吧，钓鱼岛的事情也没解决呢，南海问题又来了，其实菲律宾和越南已经占领了好几个岛了。中国政党好像没啥动作[泪]。这就是你越弱，越有人欺负你[怒]
明天要远走 : 就是不让讲脏话，不然肯定会骂赶紧滚哈哈哈哈哈哈哈
wang-小旺 : 打他[怒骂]打他[怒骂]。
薛薛薛薛薛薛珂 : [强壮]
戴着耳塞来唱歌 : 帅气逼人
傻不楞登桐小桐 : 又被我男神帅了一脸[心]
-鱼忆七秒的爱 : 要不要这么霸气！
劝说者5985298383 : 看到祖国那么流氓我就放心了[doge]
蜡笔小小筱新 : 男神霸气
Uniqueness-王 : @ToPBoXLEo 你男神
石滚滚V : 王外长直接把日本降级为苍蝇级别了，再嗡嗡嗡没完没了一巴掌拍死算了。
恋上大白牙GD : 男神霸气！赞赞赞对日本就是不能客气，没完没了了还[拜拜]
周家大大爱吃饭 : 卖av的出去[喵喵]
秦徵 : 太帅
Rhododendron_7 : 没完没了[闭眼]
是女字旁的JIE呀 : 配图霸气
Vikier谢 : [傻笑]再不跟你点颜色看看，你都不知道我是你爸爸[耶]
諵街尐枭05700 : 不要给我提日本！！
夜阑冷月寂 : [喵喵]
张小峰0285 : 霸气十足！
洋葱咖喱辣椒酱 : 黑老大即视感，帅
奔波儿灞是我大哥 : 比杨洁篪硬气！赞！
沫沫90218 : 男神啊！好喜欢你啊！男神长命百岁！
鳞逆之龙 : 潜台词就是“不要给脸不要脸”
鹿晗许嵩笑一笑倾城肖奈 : 男神[爱你]
i铁甲小妹 : 帅呆了！[爱你][爱你]
林Lin凡 : 鬼子一向觊觎我中华之国土，唯有斩草除根方能保中华之安宁
粥鲁迅 : 那边凉快去[向右]
oooylooo : 老公
风车森林 : 我男神[爱你]
kunkun夫 : 日本一脸的你能把我怎么样？来打我呀！来打我呀！
hhui要开心1994 : 不仅帅气还霸气
不然你叫我什么 : 王之蔑视[喵喵]
好乖- : 真的是没完没了
只为一朝平天下 : 对于这种二战留下的余孽，就是要用行动来了结。
我妈o近视了 : [doge]国内史上官最大的网红
Hi金珲 : [鼓掌][鼓掌][鼓掌][鼓掌][鼓掌][鼓掌][鼓掌][鼓掌][鼓掌][鼓掌]
账号N更夸张 : 回到“南海各方行为宣言”了？那还建岛吗？
七海七海_ : 望你谨言慎行[拍照]
爱吃鱼de猫Q : 我想知道碟子里放的是什么[笑cry]
ViVi井井 : 霸气[鲜花][鲜花][鲜花]
范二姐儿 : 天团王队长  今天又三米了[赞][赞]
泡菜世界1 : 霸气，我喜欢
BELIEF010 : 郭徐流毒远不及赵某事件恶劣，郭徐之流至少不会卖国，而赵某事件的结果却可能会使东欧剧变苏联解体的前科在中华大地再次上演
欣馨心晴 : 啊？
杨学义01 : 回复@初学者160628:那你打啊，微博上朋友圈里喊打的老多了，砸日本车时候冲锋陷阵的小将也是千千万万，帝吧翻墙出去爱国的优秀青年也是你们通道，队伍庞大，打吧。
用户5887862291 : 霸气
劉德華Felix : 打不能打罵不能罵，只能在微博上發表文章氣人嗎
juice年年 : 手势，再说，滚出去
l1oy : 台湾渔民登岛了，大陆呢？打嘴仗？
甜甜的茧中美丽 : 小日本让你闭嘴时最好闭嘴，不然小心让你永远开不了口，这不是商量是威胁[怒]
沙滤 : 说出国人心里话。有时候觉得日本政治家太变态！
欣馨心晴 : 谁能告诉我，为什么明明黄岩岛是中国的，我们却总是说愿意和菲律宾共同开发？我们自己的东西，能否不让别人碰？
SevenYuZ : 我男神说什么都对[doge]
xhcbkg63783fvizq891jzron25182d : 王外长谈人权的那段话，才真的叫霸气！建议大家去看看[偷笑]
白发苍苍在随你流浪 : 日本真像狗皮膏药一样[怒][哼]
陪你走过那些年的她 : 回复@我有一个仙女棒O:不不不，其实这个手势的意思是，门在那边[眼泪][眼泪][眼泪]
种花家的_小仙 : 偶像棒呆
农家猪大叔3s : 你了解中国吗？你闻过我的脚臭吗？看鞋！！！
张金汎 : 好烦，不好惹我们王毅大大生气。该死的小日本[微笑][微笑][微笑]，不要碧莲
青柠薄荷-cxm : 男神
o越位o : 这话厉害了！
Zzheng_TaNG : 就是，小日本的没完没了！我政治团的大偶像！[强]
本人已汉化 : 王大大太帅辣！[good][good][good][good][good][good][good][good][good][good][good]
下雨天里奔跑的犀牛 : 本来打算办签证下个月去日本旅游，现在，哼哼，支持国家！不去了
大阪樱花开了 : 回复@翠生生CUISS:炒作是王公公的特长。
小宇宙2005 : 有霸气！这才是中國人[赞]
明若譞 : 我昨天知道日外相要面见咱们外长就说不知趣会被削，果不其然啊。王外长v5！好好回家修你家的辐射防护罩哈，别再掺和人家家里的事了，咋哪都有你们啊。真以为住太平洋边上就是太平洋警察啊。
一件Yuyi : 求安倍别再瞎bb了[微笑]
大痞子的皮囊 : 手势是:门在哪，请滚蛋！
马队长就是我 : 傻样
tonyyd2010 : 回复@CYFfeifei:要相信党和政府嘛. 赔100就不错了，知足
劉德華Felix : 聽夠了好嗎，不要在把這種情況發到微博上好嗎，好煩，
逆行狗 : 这不是啥天团吗？被无良媒体搞的看见这张脸就恶心
北方有雪咩 : 太帅了
屁屁醒了 : 回复@孙喵喵还是孙猫猫:如果祖国爱我亦如我爱它，我当然愿意相信。可实际不是，甚至我们连说不的权利都没有！
半岛玫瑰yu : 真帅
冷泉0901 : [话筒]][话筒][赞][赞]
____没事找找乐子 : 好一句没完没了！
沉皮一号 : 人家日日日------本人，不怕嘴炮。
神话大发 : 这个手势就是 看 这儿有个傻X
勋火撩兴 : 原来都是各种协商只说希望和平解决，你们说中国软，腰杆不硬，现在中国腰杆硬了，又说应该来点实力的这样说只会让人觉得没底气[微笑]真无语了。。。
大阪樱花开了 : 回复@狍星居民7777777:你也是。。。
湛卢爱幺幺 : 银鎯蜡头枪，理他干嘛？
山竹荷叶 : 好多人每次追剧都有好多的男神，要我说这才是大中国的男神！[赞][赞][赞]
翠生生CUISS : 回复@大阪樱花开了:你这算炒作不？？
小丸子不梳丸子头 : 霸气，就喜欢硬气的领导人
基尔多雷 : 烦不烦，声索国都说要谈判解决争端了
没有微博名可以改 : @潘峰这个名字太大众 看看你男神
读者城市 : 维护祖国领土完整。#旅行的意义##Hello七月#
大阪樱花开了 : 回复@中原迪迪---冰心:你是墙缝出来的我信了。
王大大7 : 姓王的好厉害！赞！
林深初遇鹿 : 霸气！大国外交！[good]
宙斯传奇song : 回复@广府paul:作为一个国家经常让别人打脸也不是很体面的，对其在国际上的影响力是有明显削弱的。这就是软实力。
你看我可爱不可爱 : 意思就是别再没完没了了 小心爸爸揍你
文今天下 : 支持外长[兔子][兔子][兔子][耶][ok]🖖🏻🖖🏻🖖🏻
初学者160628 : 回复@杨学义01:日本这个坏东西从甲午战争开始就欺负我们，让人很生气，抓住了我们不想打仗的心里，才无理取闹。
微尘_PXX : 真是的，没完没了
大阪樱花开了 : 回复@菲力猫是最好的猫:你是金三胖粉丝？
梦想时线家 : 我单方面宣布王外长是我老公，我是同志[doge]
为你钟情00799 : 哈哈，长得就像外交部长
美术教师李雁宾 : 欢迎加。
SOS总有刁民想害朕 : 我男神就是这么帅
謎謎謎茫 : 王帅帅雄起
孟兰孟兰 : 日本鬼子[幽灵]搅屎棍[大便]
孙喵喵还是孙猫猫 : 回复@屁屁醒了:相信国家！！！
Irreplaceable8 : 男神男神～我心中唯一的男神[好爱哦][好爱哦][好爱哦]
酷炫的蛋炒饭 : 可以的，这很部长[doge][doge]
海水漫出地平线 : 外交部四宝走了一宝
必须跟热点 : 国家一定要继续发展强大，以后会越来越硬气。帝国主义欺负我们太多年了。
你是麻麻的最爱 : 帅
冬阿熟 : 就是[good][good][good]真的是太没完没了了[怒]
沐曦君 : 看着电视剧《海棠依旧》，怀念周恩来总理。如果他能够看到王毅部长，他会想，终于后继有人了。
大阪樱花开了 : 回复@掏空伱莪:你是朝鲜人？
屁屁醒了 : 永远是嘴上捍卫。日本和俄罗斯也有领土纠纷，然而俄罗斯是怎么做，实际控制着北方四岛，小日本还不敢说。看看中国……经济发展是重要，难道真的把战争留给子孙后代吗！只是维护领土主权完整全靠嘴！
冯玉芳 : 扬我国威，王毅大大威武
掏空伱莪 : 回复@大阪樱花开了:你他吗是日本人吧  滚出中国
座山观景112 : 整个一无赖流氓语言
乡村山上山人 : 劝某党不要一错再错，知错能改还有希望。不然机会错过，难回头。
晴天_有雨_雾太浓 : 为什么显示原微博删除啊，不能显示全文
fan_yx : 帅
Memorii : 菲律宾都不玩了 日本还要玩呢？
Optimisticmans : 回复@大阪樱花开了:日本的狗？
jennyJjiang : 男神
二帆tiffany : 男神再发招[爱你]
彤VeraWang : 说话太硬气[爱你][赞]
海浪小桃子 : 男神！！！
手机用户3156050502 : 回复@糯米糍丷:它本来就是狗皮膏药，它不是有个膏药旗吗
大小宋宋小小宋 : 好霸气，帅气，我男神，我大叔，哈哈[爱你]
时光R旧城 : 中国最棒！！！
杨学义01 : 回复@故城伊人情:这算什么，毛主席还对美国侵犯中国领空提出过四百多次严重警告呢，那才叫牛逼。
克洛伊婚纱摄影东旭 : 帅到爆炸的外交部长
yl_byLiang : 都是搅屎棍，没你的事还不赶紧滚，非要全世界的丢脸，还能说啥，不要脸[doge][doge]
龙舌兰110168 : [噢耶]
陆探微w : 好想配句：你这个垃圾
独一无二的晓妞子_cri : 没完没了了是吧🙄🙄🙄
809485902MK : 魅力
秦巴富硒山货街 : 对日本不能手软，中日必有一战，只是时间问题，中国只有打趴日本才能回归荣耀，日本也才会乖乖听话:，日本骨子里就是奴役命只怕强者
彤VeraWang : 回复@迦南恋太郎:[微笑][微笑][微笑]反社会人员吧，微博里全是负能量[鄙视]
轻初Panda : 帅！
啊啊啊啊啊啊啊啊都已被占用 : [doge]
阿柠吖檬 : 帅![爱你][爱你]
久夏静谧苍颜 : 我觉得这个&quot;不要没完没了&quot;特霸气
WATCHWAIN : 日本不见棺材不掉泪吗？打架叫上我。
宙斯传奇song : 长的帅气也就罢了，还那么有才情，你是玉皇大帝派来的么？。[嘻嘻][嘻嘻][嘻嘻]
举水河畔一农民 : 霸气。
wuli魏DX : 全民偶像
菲力猫是最好的猫 : 回复@大阪樱花开了:看你这微博名，亲日派[疑问]
mwkalainen : 男神帅不帅我就不重复了，默默地把骂人的都举报了一遍[拜拜]
为了提高big也是费尽了心机 : 真是的，没完没了，烦死爹了[doge][doge]
中原迪迪---冰心 : 回复@大阪樱花开了:贱人！你爹当年怎么不把你....在墙上！
丿月色阑珊 : 只哪猪
Miss__Phoebe : 别给脸不要脸
一只袁梦 : 中国南海
吞大象的蘑菇 : 表白王部长[爱你]
哥拿啤酒洗脚 : 回复@芦晓样 的赞:这是真的
狍星居民7777777 : 回复@大阪樱花开了:你…真让人…
山水如此多娇 : 一个战败国，那有那多事，小心二次核爆
大兵叔-wh : 日本再管闲事，建议把本田 丰田 日产等日本合资汽车撤了，最近留意了一下路上的车辆这三种占比例很大
丑菇凉的秘密 : 太帅了[心]
勋火撩兴 : 在这种微博下也能遇到喷子真是辣眼睛[拜拜]只能说，别忘了养你的中国，人应该有良心[拜拜]中国腰杆硬了你也来这瞎bb[微笑]
段公孓 : 被迷住了[爱你][爱你][爱你]
脱掉裤子蛋蛋凉 : 这个外交   真的很帅
贾小段啊 : 拍av的出去
奔跑吧三哥 : 帅
默默24308 : 含蓄点[笑cry]
杨学义01 : 回复@初学者160628:你上，我给你喊加油。
压力山大9527号---小陆 : 能不能自己也不要没完没了的“奉劝”，这话说几千遍了不累么
夏天里的七七 : 不要给脸不要脸[doge]
__璐了璐 : 好帅@非专业考研狗-
康师傅兔子面 : 你这么帅你说的都对[哈哈]
xlwbliuer : 帅
XXYangg_ : 日本算什么东西[微笑]@Chen-ruiyue
羅妖妖的微博 : 就喜欢这么霸气[赞][赞][赞]
汽水加糖 : 回复@龙虎大队:你觉得身为一个外交部部长  会犯那种低级错误？
www西京来客 : 维护国际组织公平、正义是每一个国家义不容辞的责任。
博主黄鹄 : 😀
lotusiii- : 霸气
MMM心之所向便是光 : [强][强]
陈月半喵呜喵呜的爆炸头 : 可以很中国，我要表白[笑cry]
换了ID你们就不知道我是谁了 : 部长:信不信我炸了你[微笑]
小宋纸 : 好帅啊，没完没了
墨坠落花州 : 谁能告诉我日本为何如此不要脸？？？？？？？？？？
炽沨子 : 说的好！帅
换成基哥怎么样 : 没完没了这个词真是精辟，教育与鄙视尽收话下。
樱花搽 : 根本就没必要与日本谈，直接推平算了！
欧美高清视频olo快上车 : [doge][喵喵][doge][喵喵][doge][喵喵]
nbyjw1978 : 干死鬼子
yl_byLiang : 部长真是霸气又有个性，你们就是我男神，我不爱小鲜肉了，很棒[good][good][good]
胖嘟嘟的伦儿 : 没完没了
方人也一雨 : 女优国和女佣国屁事不要这么多[微笑]
一根自来卷的猪尾巴 : 给大家介绍下，这是我的新男神[害羞]
深情的张大白 : 大大大大王[心][心]
安德施丹 : 蠢才真是太多了。外交部表态根据的是党和政府的战略，更体现的是中国国力特别军力增强，不是某个人的风采。
大阪樱花开了 : 王毅不仅长的像公公脸说话胡搅蛮缠也像公公一样恶心。
弯弯姐地盘 : 配个画外音：门在那边，滚出去。[哈哈][哈哈][哈哈]
00嘟嘟00k : 强硬
王倩YiAn : 嘿，我男神[爱你]
冷-冷-碎 : 回复@only-阿连:你们这么无脑有能力爱国吗？
耳畔有声世界有色 : 硬气
和莉莉的第1天 : 帅！王毅大大
龙虎大队 : 缺少外交艺术，只是博得了眼球，真正的外交家，沉稳大度，尽最大努力，艺术智慧的与各国人民友好交往，更不要给大局添乱子，懂得疏解危机，最后还是维护国家和人民利益。
柠檬雪条 : 有些人就这么仇官……什么都骂啊
火星上滴伊娃 : 霸气
qwertyuiop新 : 底气十足，狂赞偶像
贾先生Hello : 奉劝你老老实实卖小电影，不要作
凌寒Cissy : 不要一错再错，没完没了！
王飝wang : 大人物的风范
翔儒所爱 : 这部长就是一个大写的帅啊！
大艾小枚 : 以为靠着美国，就可以像美国一样世界警察了？何况，美国也就是搅屎棍
舞毛苟的灵道 : 对他的看法可以检验一个人的智商．．，
断桥风雨情 : 小日本真是闲事管得宽，裤儿反起穿[挖鼻][挖鼻][挖鼻]
集齐七龙珠召唤神龙 : 回复@迦南恋太郎:作为浙江人我替你感到耻辱。你不帮中国说话。还帮美日说话 你巴不得南海被划出去。巴不得中国孤立无援你才开心咯
嘻嘻ABCDXYZ : 男神
Romane-Conti : 能够亮点实际一点的东西不？这样说说毫无任何震摄力！让人家觉得好弱……
随和的Carol017 : 大写的帅[爱你]
琳盛夏 : 我在缅甸  我永远支持中国[心]
画凉染 : 男神[嘻嘻][嘻嘻]
徐玄琳 : 王大大帅帅哒[爱你][爱你][爱你][爱你][爱你]
根深静待叶茂 : 无语
故城伊人情 : 有这部长，我们就放心啦。。。王部长辛苦了。。。致敬
A乄Loser : [斜眼][斜眼][斜眼]
琳盛夏 : 我在缅甸  我支持中国[心]
做人别太FLB : 此人多半有病.jpg
糯米糍丷 : 讲真的   日本怎么和狗皮膏药一样甩都甩不掉   真他妈烦人
鲸鱼和她的猫 : 男神发话了
田考儿 : 王伯伯说得在理。
我稍微有点缺心眼Atclouds : 没完没了。。。。是不是觉得烦了。。。。。
王宇onemeu : 中国威武
郑州市一个好市民 : 避而不见，向中国人民低头认罪时才能会务谈判中日两国和平友好事宜！
懵懵哒的姜先森 : 男神啊啊啊啊啊啊啊啊
im90s宝哥 : 奉劝日方山口猪不要给脸不要脸
广府paul : 问题是，即使日本继续说下去，你拿它有什么办法呢
王大羽的杂七杂八 : 太帅
诺_lie : 男神啊
1朵小云花 : 小日本别没完没了
X_Vivian : 这边是门，滚～
笑成尴尬症 : 意思就是说，小日本，别你妈给你脸你他妈不要脸！
黃美玲73197 : 潮汕方言为：扑领母，细开起
政委家的草 : 这个外长我服气[心]
纯一姐粉 : 没完没了 哈哈
-----Pisces : 我们的王叔叔 怎么这么霸气呢[飞吻][飞吻]
初学者160628 : 对付得寸进尺的小人的最好办法：给点颜色，教训一下。
符HONGHUA : 没完没了[doge]
小小小小小滟 : 霸气
用户5227621653 : 帅！！！
i橡果先生 : 打死小日本
诗小灿de固执 : 男神说话就是霸气
能有名字不被占用的吗 : 就应该强硬
安尺半然 : 憋没完没了！(正经脸)
懒傻欢乐多 : 不要没完没了，有你啥事！
only-阿连 : 回复@冷-冷-碎:[吐]
嘿期待着一个幸运和一个冲击 : 这是谁的爷爷，麻烦出来说说老头在家是不可萌啦[馋嘴][馋嘴]
乞讨de小米奇 : 是呀！日本太能，你太能咋不上天呢！整天胡搅蛮缠，你这点小心计骗得了世界也骗不了我们！
Toxic_ls : 我爱豆就是帅！
小小的悲歡 : 其实站在日本的角度确实应该心急，经济的衰落，宗主国重新崛起，南海命脉被控，换我是安倍我也急啊，可惜我是中国人，所以我兔加油，逼死小日本！！[偷笑][偷笑][偷笑]
穗什麼 : 回复@LJ-ZZOO:人家的财产，关你屁事
欺负兔子的小草 : 男神威武[心][心][心]
Dazzaling : 男神好帅
冷-冷-碎 : 一堆爱国粉红苍蝇！[吐][吐][吐]
only-阿连 : [doge]没完没了
大侠铁流 : 竟说些废话！那不正是人家的策略吗？！
用户5316920229 : 巴掌大的一个地方，有什么资格挑事
L-被风吹过的夏天 : 男神不仅霸气还很帅！！！[色][色][色]
我的女神在嘛 : 打嘴炮有什么用，又扰不到鬼子的七寸
靜靜的鬧騰7 : 男神
金牛座的夙愿 : 日本啊，你个龟孙现在是想怎样你说的了。废话屁事多的要命，好像有美国撑腰牛逼一样。再说了没了美国我估计你们早就进了中国版图了
善良牦牛 : ？
爱学习的大天使 : 王毅男神[心]我泱泱大中国就应该培养出这样威武霸气的官员[心]毕竟你们有14亿粉丝[闭眼]底气足[鼓掌]
我只是一只僵尸粉嘤嘤 : 哈哈哈，别没完没了！打你哦！@love_my_ba0
Worship_adore : 岛国真是烦人啊，哪哪都得插一脚……
稀稀-燕子 : [good][good][good]
奥娇马 : 小日本   打死你个龟孙
洛洛洛洛丽塔呀 : 男神帅气
温油小青年 : 日本鬼子烦死人了
caroline_盒子 : 大写的帅[酷][酷]大霸气侧漏[酷][酷]不愧是我男神
脑残妞就爱吃生姜 : 帅炸啦
一卷诗书润红妆 : 直接揭破小日本图谋：不管南海如何，我们都目光如炬关注东海。而且，也绝不敢忘记八年抗战！
迦南恋太郎 : 好像60多个支持天朝的国家也不是当事国，王太监你的G点在哪里？
本宫不死妾终究是妾 : 妈呀王毅太帅了
相信我是一个有故事的人 : 霸气警告！[good]
老书 : 和东盟，防美帝，训日本，外交策略还是很到位的。
小huanhuan521 : 你还帅的没完没了了
萌萌还是梦梦 : 俺们不惹事，但俺们也不怕事[坏笑][坏笑]
进击的豆腐花 : 新外长是强硬派喔[good]
宁木杉 : 直译：不要再BB
Eauker : 帅就一个字，我对他说了一万次[微笑]
董先生的兰州 : 可以 够味道
谝谝传 : 翻译:别他么的给脸不要脸，在背后使坏撕了你丫的[doge]
午夜偏冷 : 王毅爸爸请受我一拜[爱你]
神魂不颠倒 : ？
Amy_小荔枝儿 : 辛苦了
lo23and24ve : 总有一天要把小日本干倒（女优除外[嘻嘻]），君子报仇，十年不晚，先把经济发展强大，再研究武器！
小哼哼哈嘿 : 霸气！[噢耶][好喜欢][好爱哦][羞嗒嗒]
刊吾 : 我的头像是如此帅气
江雨风舟 : 你是来圈粉的吗
Iwatching : 柬埔寨是当事国？
平之- : 没完没了，硬要拉着我们炒作，我们不想理你，并向你丢了一个韩国。[笑cry]
山虎虎 : 自由从来是个敏感词啊
许妳一诺 : 估计下班后他说的这些话早忘了，又得第二天上班后才记得，然后就又是那些抗议谴责之类的话！
二笔桃花青年 : 我喜欢这一届的中国领导人[微笑]
安静zhiyong : 霸气外露
倾尽芳华与君长留 : 男神就是霸气[good]
夏级光影 : 欠一顿痛揍，不然还是没完没了。
通阿通阿通 : 回复@LJ-ZZOO:学过语文或者逻辑学没有？正义和公示财产有关联？
IenorihanCharli : 老王是我hero[嘻嘻]
陈晓盗 : 一句话就说完了，还用说这么多吗？日本，你想死么？
羊肉卷和甜甜圈 : 哈哈哈哈哈蓄意炒作哈哈哈，大写的赞！
是人是墙是寒冬m : 真·男神[good][good][good]
錵在_NJR66 : 我们部长说啦，不要给脸不要脸[拜拜]
等待清清 : 虽然有进步，但是也不必急着叫好。对日寇，我国不能再一味消极防御，更应该主动积极进攻，外交部应该强烈批评日本不尊重历史问题，慰安妇问题，731部队问题，南京大屠杀问题，靖国神社问题，钓鱼岛问题，琉球群岛问题，甚至偷袭珍珠港问题等等。
雅泅 : 很中国，很China
倦眼经秋ok : 就一个字！超级帅 (ෆ ͒•∘̬• ͒)◞
头发距肩半厘米 : 谁都别跟我抢，王毅就是我新进男神#王毅外长#
赵赵赵温凉 : 王外长霸气十足
子皓Leo : 呵呵 我天朝最擅长的就是开新闻发布会声明主张立场
Westbrook_GOAT : 卖av的。出去
教主T-T : 一定要赞啊！！！
周双屿小子眞帥 : 小鬼子真TM的不要脸。狗日滴
吐蕃王 : 这图分明是指着东边那条毛虫：戆伐
库奇葩瘙 : 小日本滚一边去[哼]
我爱拉迦迪玛 : 这语份量己经很重了
Ncmik : 日本怕的很，毕竟南海是他们生命线，能不急吗？[阴险][阴险]
7-31芒果台看诛仙青云志 : 日本就是搅屎棍二号，毕竟日本它爹美国是搅屎棍一号[微笑]
AnlicaHan : 大概意思就是：别给脸不要！
紅塵人易老 : 强硬派，敢说……
青栀巷 : 大写的帅[爱你]
妈呀天了噜 : 外交男神！！！！
光1978zk : 帅气
大小姐人品爆发 : 看到我男神这么直白也就放心了！前排留名！！我要上热门！！！
華子煒- : 部长威武！
意大利足球新闻 : 回复@Berry-be:可爱[哈哈]
峰景不殊 : 错了你就接着奉劝呗！
SIR-雅安 : 王外长 霸气[酷]
ilbj_ : 回复@筱v淡定:欢迎中方来日[doge]
Verywang- : 我们老王家的爸爸就是帅[鼓掌][心]
酝之淘 : 霸气，
ZERO-距离 : 我是种花家的兔子！
ww漸行漸遠 : 没完没了，烦死人。真讨人嫌，自己还感觉良好，辣鸡
你的名字是爱情Q-Q : 中国爸爸生气起来连自己都怕[挖鼻]
带着微笑仰望 : 通俗的讲，别给脸不要脸
sweet_vanilla : 说的好！日本这样不要脸的民族就应该被打脸！
SL_SN : 王:好话说着不听呢啊？非要给你白眼
播磨白木屋 : 以前的驻日大使，对日本社会及各政党是非常了解的。。
大淄博小哥 : 淡定眼神中散发着不屑。[doge]放松的食指上充斥着鄙视。[doge]
思路日暮 : 日本再插手，在招惹天朝，哼，没有东风快递，我们有表情包，表情包表情包
来自远方111 : 日本，最欠揍的民族。美国给它俩原子弹，它奉美国为主子。它当年侵略中国，犯下滔天罪行，中国仇视它天经地义，它仇视中国只能说欠揍。
关山难越__ : 表白王部长[爱你]
loveZhuYZ : 我突然好庆幸我是中国人，，有一种来自国家的安全感，没有战乱，没有性别，种族歧视，真好
专属小故事 : 不要没完没了，中国爸爸的忍耐是有限的
happiness_youpi : 看我男神这气势，这颜值，能甩日本好几条街了
卡布C兔 : 新晋男神告诉你，什么叫神之蔑视[偷笑]
wangyong1011 : 我老王家好久没出大人物了[doge]
HF要发财 : 配图好评！
PakChiSuri : 哈哈哈哈，我奉劝日本人不要一而再再而三的刷存在感[doge]但这又刷出了什么呢？（洪磊）[笑cry]
ln刘艺ln : 你给老子注意点，别没完没了，老子发起脾气来不是你承受得住的[微笑]
莫婉猪 : 真心觉得帅
哆啦叮当biu : 太帅了
挽鹿mio : 真是的，我男神怎么又上热搜了[doge]
韩之薰的小窝 : 这魄力，[赞][赞][赞]
7-31芒果台看诛仙青云志 : 男神霸气[心]
张先森0309 : 别没完没了。王毅部长帅气[爱你][爱你][爱你]
蔡蔡啊呀 : 没完没了，霸气
赵国临时居民- : 看到评论区这么多五行欠爹的奴才，我放心了。
吉安妮Annie : 日方领导人长长脑子吧[拜拜]
爱哆啦A梦梦梦梦梦 : 最近迷上了这个威严霸气却又萌萌哒的王外长[哈哈][哈哈][哈哈][哈哈][哈哈][哈哈]
楚凡予 : 超好听的话
渡时远 : 男神！[爱你][爱你][爱你][爱你]
糖糖糖_atang : 偶像！！！
我不是高小雯 : 我男神又上新闻了[喵喵]
三里满天星 : 回复@我有一个仙女棒O:Nike. 真有才华
聿铮亦笙 : 这个图应配门在那边，不送
微个博还要昵称啊 : 没完没了
自嘲自闹自发癫 : 意思说，你他妈的在没完没了，就把以前的旧账新账给你全翻咯
饿货ELF在东海里找吃的 : 王大大好帅啊
小胖峰子 : 霸气！
黄玲Caroline : 男神啊
supertomatoqq : 只会过过嘴炮瘾？
xiaoxiaomi70 : 转发微博
hw3908 : 这相当于当面打脸了
灵魂梦飞翔- : 我王威武[good][good][good]
阿鹿的迷妹 : 霸气[酷][酷][酷]
交好的女友哪有那么顺手 : 王毅爸爸太帅了[泪][泪]
赵来龙-五岳鲜峰 : 别没完没了，霸气啊！
听那个男人的谎 : 讲的漂亮，威武
殇丷 : 转发微博
再瘦你马儿比骆驼身材好 : 言下之意是中国不是十九世纪的中国，日本也不是。
还是当年的颜色 : 我想起我爸每次骂我都说…你是不是还没完没了了
喜欢你阳光下浅浅的笑 : 不要一错再错，没完没了。这句说得好
暮云收烬 : 王之蔑视！
用户94529 : 一个是卖香蕉的，一个是卖AV的，你们好好卖就行了，闹腾啥？
Berry-be : 回复@意大利足球新闻:我不管，我已经单方面宣布了。
栋材 : 账已记下
南音198506 : 祖国威武
Kuo爱的胖子尹 : 最喜欢部长的招牌白眼
舞曲篇子 : 王毅我男神，谁也不要和我抢！[崩溃][崩溃][崩溃]
兆九洲 : 日本就是在耍中国。借助中国的强势来发展自己，修宪成功要感谢中国。你越反应对他就越有利，正中下怀。他太希望你这样了，他最安定的是中国不敢打他。不信试试看。
ChouFEIWA : 好帅哦！
十年天真z : 大娃娃我
雪飘清晨 : 粗俗莽汉
乔氏女妫烟 : 男神又帅了！！！
伟大的宣委 : 霸气
牛津高阶英语词典 : 霓虹国真会给自己加戏[微笑]
老纠结家的小纠结儿 : 安倍就是搅屎棍
小丫小丫猫咪 : 好棒，加油，
联络人93号发言人1号 : 说白了，日本真的很想抓住这次机会好开战
Wendy杨小白 : 天了噜男神好帅 没完没了一句太傲娇霸气
峥嵘岁月长C : 回复@索阿萱:唉老男神
勋常人 : 帅
蓝花花儿的红丝丝 : 没完没了[眼泪]
最近有点闲下来 : 男神[色][色][色][色][色]
花开为谁思 : 臭表脸的小日本
把高圆圆还我我要睡觉了 : 王部长不怒自威[色][色][色]
貂蝉高飞2016 : 小鬼子就像一个特别顽皮的小孩，说教对他根本木一点用，抓起来一顿拳脚保证乖儿子一样，而且将来管一辈子。
dwzbb : 日本极力想挣脱美国的狗绳，另一方面又为虎作伥，我们要时刻警惕这个恶邻
妖朋ART : 男神[爱你]
咩咩掌心的熊宝宝 : 霸气威武！
希林莎莎 : #抢镜小公举王外长#看到外长必转[哆啦A梦花心][哆啦A梦花心][哆啦A梦花心]
鹿晗你撩到我了 : 我是小日的脸，它不要我了[微笑]日了 [狗]
连衣裙玫瑰巷 : 好霸气[心]我男神哎
SH_栀子花花语 : [good]
荷渡紫云英 : 天团我站洪磊[doge]
灬二丁目 : 哎 喊口号无数遍了
-罒3罒-鸡涌阿 : 赞
作文稿 : 再没完没了，你爸爸不收拾你，你爷爷就要出面整顿你了
王王宇彤是淑女 : 王部长不想理你，并向你翻了一个白眼还赠送一个屁[微笑]
崴areT : 日本欠日啊！
用户5616222845 : 王毅V587
亲爱的你6888 : 王毅欧巴发话了 别得瑟了
惡藦joy : 周恩来之后，我就服你！
Mia哈哈哈 : 部长，最棒，最棒，中国骄傲[爱你][爱你][爱你]
KD黑马 : 牛逼
菍儭翽翽翽 : 炒作[笑cry][笑cry][笑cry][笑cry]
桂哥哥在此 : 韩国也并没有给中国带来实质性的利益，反而是中国对韩国的过度信任包容和开放，导致从韩国进口的垃圾产品泛滥，娱乐影视泛滥，娱乐明星泛滥，赚的钵满盆满还侮辱中国人，简直可耻，如果他们不是国土面积小，资源稀缺，势必比美国和日本还要狂妄[挖鼻][挖鼻][挖鼻]
我麋鹿_la : 王大大粉丝观光团前来报到[害羞]
lh7deerW : 男神so cool[瞧瞧]
柒_Kashiwa : 王公公，您也就敢逼逼日本，毛子干爹呢？人可是在南海一样下手了，快去申讨啊！
一碗菜花梗 : 我外长威武！！！
_林夕呀 : 翻译成白话就是别他妈给脸不要脸
王外长的小迷妹 : 前排挤挤，表白男神！[爱你][爱你]
我要做一个大胖子 : 一直在强调别bb，然而一直都在bb
星星的你1314123 : 霸气
专注的小孩 : 有没有视频啊
吴亦凡崔胜铉mylove : 你们列强欺人太甚！[微笑]
吃可爱长大的元气少女 : 日本真是无聊，天天蹦哒出来给自己加戏，刷存在感[哼]
Sophia的索菲亚 : 小日本就是欠收拾！
顾以安Zoe : 我单方面宣布这是我男神。
秉笔直心 : 别逮谁喊谁老公好吗，你让人家夫人怎么想。
cejcusmq : 我是王毅蜀黍的迷妹[笑cry][笑cry]
各种等各种买各种期待 : 天团队长大人发话了，岛国不要蹬鼻子上脸何况你美国爹还没给你这个脸呢
诸子百家之一 : 琉球问题或可再议[拳头]
Dudu_Yj : 男神霸气！！[玫瑰][玫瑰][玫瑰]
斯状镉儿h : 死不要脸
Beijingfad : 小日本了解中国吗？来过中国吗？知道中国有多少人把过亿钞票存在自己家里吗？
小羊羊汪汪__ : 就是的！[哼]没完没了
sunny许聪明 : 我就喜欢这么霸气正漏的王大大！！你什么货色我就什么脸色[酷][威武][威武][威武][威武][赞][赞][赞][赞]#南海斗争##外交部长王毅#
傻子哟嗬 : 霸气!!!
举目浅浅荷叶色 : 不是看国家面子，估计会说，关你屁事关你屁事关你屁事[哈哈]
翎抉 : 全国人民的偶像男神
啦啦啦啦太阳 : 为我部长点个赞
zy6819 : 有理你怕什么?一点都不能少说到做到.最好把俄爹那里的几百万也讨回那才叫威风
李慧娴_halo : 你长得帅，说什么都对!
我叫顾小肉 : nan男神你好帅！
你si谁啊 : 日本鬼子不要再逼逼了[doge]王之藐视
焦红扬 : 转发微博
再现苍穹2今夜无眠 : 王部长越来越帅了。
高小贱的微博 : 王爸爸对日本人说:门在那边，自己出去还是我放狗
流年-无殇 : 回复@黑和蓝:这是中国的嘴巴好吗！
用户5666739844 : 男神
小白_吃货基的3陪 : 门在那边，小日本出去！
龙言1947 : 外长左手一指，大长国人志气！
凤梨冬菇茄子 : 日本要是跟中国站同一队，保证食品业腾飞旅游业gdp翻倍，真是执迷不悟[怒骂]
胡歌老婆杨薄荷 : 哈哈哈，没完没了说得好，不愧是我粉的天团团长[喵喵][喵喵]
被窝姑娘不赖床 : 帅一脸[微笑]
广东塞壬 : 不知道为什么老王说话极具喜感。。
别用你的白眼瞄我 : 可是钓鱼岛日本是当事国啊。钓鱼岛还几个人记得
MissJevin : 王毅叔叔好帅[爱你][爱你][爱你]我男神
西岳西 : 小日本就没有了，以后只供科学研究做水底科学研究了！
文子苑登 : 眉毛真帅好抢戏
木其勒MUMU : 日本你听着没、别没完没了[怒骂]
滨州城事爆料 : 王部长，你就是棒棒哒
M谭点点M : 大同方言   日本你真寡，闲的没事儿干你是[挖鼻]
不被遗忘的音符-如沐晨光 : 回复@LJ-ZZOO:哦
天之娇子----天马 : 应该灭了小日本。[怒]@程国强观察: 挖墙角，搅局使坏，小动作不断，如何修理教训它？
南子vvv : 其实日本民众根本不知道南海仲裁庭的那些事。日本媒体对国内宣传还是以日本政府方针一致。根本就是罔顾事实
唐小凤是最帅的 : 王毅有微博吗？关注关注！男神就是帅
LyifJeong : 我男神无论在哪都这么帅！
用户5643230746 : 回复@我的老婆有点萌:还能敲你
时时恋恋 : 小日本 处处跟中国对着干[怒]
Mr_凡脱线 : 有祖国罩着我，感觉倍自豪倍得意[喵喵]
她叫陈小乖 : 帅@谁叫徐小怪 @我是南很好
郑秀嘤 : 我宣布这是我男神[微笑]
五味子茜 : 日本人……。呵呵
种花家小圆 : 果然是天团团长啊，外长威武[good]
三分热度七分真 : 看来小日本是欠调教了
IrreplaceableLAC : 这个屌[眼泪]
泉水叮东响 : 鹰酱家癞皮狗[兔子][围观][吐]
showlolat : 全民男神[爱你]
爱笑的欣妮儿 : 王部长真帅[威武][威武][威武]
太阳阳_花花 : 全国都是情敌[挖鼻][挖鼻][挖鼻]
串串果汁tririfantasy : 没完没了
空巷里的旧时光 : 小日本无权发言
尹书秀 : 就是这么牛逼，，，，男神，，，
算命先生给起的好名 : 外长是我爱豆
水泓2007 : “没完没了”[笑cry][笑cry][笑cry]表白王毅部长！[good][good]
苏槑特 : 门在那边[微笑]
小小北岛7121 : 真帅
种花家侯侯 : [偷笑]穿木屐的，门在那边
逗妹ya : 没完没了一词用得太精准了！
DOG洋峻 : 外长大人长的好像一只猫
向往猪的幸福 : 大写的帅！我男神！
勿忘初心-never : 就是这么硬[强]
风月星辰12 : 部长[威武][威武][威武][赞][赞][赞]
yoyo臭蛋 : 男神[心]霸气侧漏[羞嗒嗒]
杨老板么么哒 : 一错再错没完没了！太帅了
与好运相伴 : 南海是倭国经济的半个生命线，他们怎能让中国一家独大，锁住倭国的咽喉呢。蚍蜉撼树，痴心妄想！提高警惕，粉碎倭奴的阴谋！
围场农民包十一 : 俄罗斯和日本在南海帮助越南开采石油…………
小时候小孩子 : 男神
落流漓 : 迷妹来啦[哈哈][哈哈]
陌Crystal陌 : 霸气[good]大爱[鲜花][爱你]
用力大笑靓 : 霸道帅气
一条香菜鱼鱼 : [good][good][good][good][good][威武][威武][威武][威武][威武]
我被柠檬咬哭了 : 王毅大大做的真棒，以后您就是我偶像了
daihuixuan : 王部长帅气！
Mr_凡脱线 : [噢耶]
芜湖锁王开锁 : 无论哪个时代:口才是必要的？手软是治理给人民看的？
金秀贤他说爱我啊 : 只想说我大中国男神团之一   干的漂亮
努力努力在努力的sheep席 : 我只想说深深爱上了这个男人[花痴]
蜕变思想者 : 至始至终就不能给日本[日本]@日本国驻华大使馆 好脸，骨子里从来就没有过安分守己的思想，所以应该用句老祖宗的话来反馈它“见一次打一次！”
众里寻茜千百度 : 小日本，我们王外长发话了
莲子仨 : 日本这根搅屎棍！
MR-庄子 : 男神[爱你]
寻找本命的傲娇森肆 : 男神就是帅气。11区，不要没完没了
gysmoon24 : 回复@旷野不寂:请问咄咄逼人的是谁？要是外交长没这气势别人还以为中国好欺负！这叫大国立场
小罗12211 : 有用吗？
射手座任性娃 : 太霸气了[太阳][心]我男神说了，别一错再错，没完没了，没听懂嘛[怒骂][怒骂][怒骂][怒骂]
同学王云 : 王毅老公
意大利足球新闻 : 回复@Berry-be:你妈妈同意吗[害羞]
大脸妹和小死狗 : 我男神[喵喵][喵喵][喵喵]
StaceyXii : 脑补出王毅大大蔑视的眼神！
浴妮享悦 : 就一错再错，就没完没了，看你丫能咋的？我就不明白了，跟鬼子讲什么道理？对牛弹琴
大胖猫脖子短 : 我心水
不过如此507 : 叽叽歪歪的日本人。再叼小心中国干你
西岳西 : 把菲律宾收拾了，以后你家再请菲佣就是免费的，完了再让越南打完男人，派出我国的剩男去帮助越南改善基因，如何
kylin羅賓 : 看到男神我就滾進來了[doge]
贪吃小河豚 : 王团长[威武]
Y上车走吧 : 狡诈的敌视国！：小日本！
风雅老宋 : 满屏的意淫
real__Zm : 霸气[酷][酷]
美爹我来了 : 没完没了就打烂他们的嘴
政治嘉思想嘉文学嘉教育嘉 : 就是这么霸气
为你声沙好吗 : 真的，不管是人与人还是国与国，不要在交往中挑战对方的底线，我们不是不讨厌你们，只是我们的国家领导人更心系民众，他们知道和平是对我们最好的保护，但是你们还是不要一再的挑衅了，我们爱好和平，但我们不是软柿子[微笑]
冷-冷-碎 : 回复@WilliamWallac:蜡脸很帅吗？
相信未来Jerry-Chee : 这个要比之前的强烈谴责吊多了[good][good]
于是然后呢 : 帅帅帅，不要没完没了[赞]
CarStyling : 回复@LJ-ZZOO:一片微薄小人心
sonia宁 : 外长威武[good][good][good]
机器海豚 : 找日本的空子，也搞搞事儿啊，以其人之道还施彼身。
阿麦小莉莉 : 赞！
我的老婆有点萌 : 除了说  还能怎样[挖鼻]
PTA老王子 : 日本人不会惧怕嘴炮，只有打服他们才服气！
用户5936466361 : 王毅部长太霸气[爱你][爱你][爱你][爱你][爱你]
头疼的诗人 : 王毅，草我[色][色]
灿烈宠儿呀 : 国民男神[心]
用户5234607138 : 这算美男计吗？
MCHLD : 霸气侧漏
ooosehunooo : 王外长霸气
yuekris : 男神帅
zyqxhn : 果然男神啊
孀叶莨lys : 就是欣赏这种外交态度！[good][good][good][good][good]
大熊啊ni : 男神
动感超人--哔哔哔哔哔哔哔 : 男神帅帅哒
远方很远很远很远很远 : 偶像[可爱]
猫小媛儿 : 王毅：你给我出切～
美洲豹微博 : 我是来看外长的
honey温都苏 : 男神 威武[心][心][心]
换个ID吧233 : 意思是闭上你们的臭嘴有那么难吗？
白鹿弥生 : 再说话我日的你下不了床[doge]小日方
Mreecd南北路 : 有脾气就打
美美哟i : 看我男神！[爱你][爱你][爱你]
消极地放弃抵抗 : 王老师这么厉害，打呗。
炫酷的鹿妹er : 王者﹒[中国]强国
是比伯夫人i : 熊孩子ヽ（・＿・；)ノ太让爸爸我烦心了
手机用户0000725 : 别都叫男神了，都快去补新闻！！
荞饭 : →_→@捉鸡逗逼:我单方面宣布王外长是我干爹[doge]
王照闲 : 王姨威武[赞][赞]
陌上舞狐2013 : 王外长辛苦了[good]
那年杏花吹满头 : 男神！
柒月柒日的風 : 王大人威武[爱你][爱你][爱你]
大兔砸咩 : 哈哈哈，没完没了[偷笑][偷笑]我王大大觉得你招人各应了还不走[doge][doge]
JEFFYANGGG : 2333333好直白[笑cry][笑cry]
吃马里奥的蘑菇kechikechi : 可以 这很部长
周粥粥爱吃饭 : 互不干涉内政
程国强观察 : 挖墙角，搅局使坏，小动作不断，如何修理教训它？
朱雀生南方 : 将日本冲之鸟是岛是礁提起仲裁
彦清清2013 : 不一错再错就不是小日本啦。
guduhz_7 : 我第一次看到王毅，我朋友就说了句“威严”。[心]
唯音樂永恆XIXI : 部长大大在鬼子那儿当过大使，就他们那心思早看透了
梁丫丫喏 : [嘘]你是我爱豆
顾南桉 : 我男神就是霸气！
JC小企鹅 : 霸气
alwaysFancyU : 感觉还有    滚蛋   俩字没说出来[doge]
嗬嗬嗬嗬xi : 帅！[鼓掌][鼓掌]
小yi哒哒哒 : 日本就是欠操！
be_maz : 王爸爸威武[鼓掌][good]
打不倒的哆啦梦 : 王爸爸说啥都对
心大的懒人 : 哈哈哈就是   不要没完没了好吗  一边待着去
满城花不知 : 噫，小日本滚一边去。男神爱你，么么哒~~
我可以不填吗 : 你就这样深深的迷住了我们
虫儿莉莉 : 我男神[爱你]
飞天小朵朵 : 王伯伯向日本投了一个白眼
安子墨i : 帅气[哈哈]
硕过雷雷 : 奉劝有用，日本早归顺了
13-Pamy- : 王毅外长我男神啊啊啊啊啊
恰到好处的宋青年- : 贱人就是矫情
低调生活--me : 日本完全是多管闲事，没事找事，主要是太闲了
橘子柠檬鹿 : 部长霸气，小样再bb干死他丫的[有鸭梨][有鸭梨][有鸭梨]
鸟雀不知郊野好 : 真是个自以为是的蠢驴（王某）
常熟市东南店平安车友 : 瞅啥瞅[偷乐]，瞅你杂滴[害羞][害羞][拜拜]
都市狙击手 : 给他脸了!
想要安静卖狗粮 : 回复@LJ-ZZOO:凭什么？？？
子闳的闳茶 : 王毅部长帅炸了，赞赞赞，[强][强][强][强][强]
L陌上花开H : 帅气的王外长[耶][耶][耶]
格子先生V : 我朝奴才逢人喊大大叫干爹的本事，真真的绝。
萌皮皮姑娘 : 帅！
夏日之雨2012 : 痞子流氓样
甘肃农业大学农学院-志服部 : 男神[脸红]
CHENHYiii : 我男神
張Shang員 : 牛逼！
remember370旋转 : 太帅。。 国人都爱你
ToSticker : 王毅部长长得有个性
Zhan占呀- : 日本[日本]靠边站[怒]
索阿萱 : @峥嵘岁月长C 霸道
中山炮壳儿 : 小日本再没完没了就让他一了百了[怒骂]
我姓宋不送心 : 王爸爸[爱你]
默羽系 : 王发话了，[NO]
09771--- : 男神
喜欢烊烊的孙同学 : 哈哈  给外交部长点赞     太他妈帅了
臭元的萌川川 : 王毅:爸爸好生气！爸爸快保持不了微笑了！[哼]
微光海莉 : 越来越帅[爱你][爱你][爱你][爱你][羞嗒嗒][羞嗒嗒][羞嗒嗒][羞嗒嗒][羞嗒嗒]
疯了的神原欲雪 : 我们王部长就是霸气[good][good][good][good][good][good]
快来小二96639 : 如果，，，，，，，
Konan-Z : 真的太帅了   外交官就应该这样啊
露露会一直等允浩 : 说话就是这么直白，我喜欢[酷]
大眼其实是小眼 : 我家爱豆说啥都对[太开心][太开心][太开心]
易块绿豆糕 : 怎么删了!
浪浪浪Pecking : 男神，帅气[心]
种花家莲宝 : 泰国部长：如果我是个女人，我一定会爱上他的[心]
skj239323 : 我喜欢部长的这句“别没完没了”！
陈嘉笑 : 外长大人，最帅了，厉害，崇拜。
天天无心无肺无悲无喜 : 我爱豆说的对！
一直傻傻的逗比猪 : [爱你][爱你][爱你][爱你]男神发话了，不乖就揍吧男神！
亻可女肙 : 我主要是来看男神的
靖_慈 : 我是王外长粉丝[haha][耶]
容大老肿 : 日本人就忒么苍蝇一样！
Bottle_LX : 表白外长男神[爱你]
衣依不舍服饰 : 日本[狗]就是诸多不便，诸多事务的，日本[狗]
vanora1314 : 日本就是条癞皮狗！
小六和牛 : 就喜欢男神这么霸气[doge]
贺兴康 : 最后的警告？
Elaine李小爽 : 外长威武
kkkk可卡快 : 嗯，多劝劝吧
猫十七Mao : @我还没有遇到你_W 又帅出新高度[哆啦A梦花心]
糯米团_95420 : 帅！
ilbj_ : 日方 [doge]
丶我就是徐抠抠 : 男神你说什么我都接受
用汰渍没污渍Z : 能干架就少说话
ashessssssssss : 男神好帅，赞！[good]
柿子花开了 : 他都不知道一错再错多少回了。。跟他们那么多废话干嘛。直接无视他们
芦苇W悦悦 : 给力，我的心愿是世界和平[眼泪][眼泪][眼泪]
大同世界_因你不同 : 看见男神就点进来了
YJYJ默默 : 部长你好帅！[爱你]
PINNT_ : 帅[闭眼]
Alex你是一朵大奇葩 : 傲娇男神[doge]
幸运幸运再幸运L : 王之蔑视[白眼]
EOIND反正 : 王毅：憋再没完没了了我告诉你 再这样我可转换成高冷风了[微笑]
三只肥嘟嘟左衛門 : 回复@mrdaods:加一
讲一个与繁花盛开最贴切的不幸 : 简单来说，“就你事多”
旷野不寂 : 作为一个外长，怎么老是一副咄咄逼人的架势呢？
嗯哼啦5503883985 : 男神霸气!
一般大仙 : 外交不都是没完没了吗？
柒明微 : 外长最帅，外长无敌
灿烈宠儿呀 : 日本嫑脸！！！虽然我一个人力量微小  但我一辈子拒绝日货！
LJ-ZZOO : 王部长如此正义，公示下财产嘛
不发烧少年 : 要给王部长起个爱称[坏笑][坏笑][坏笑]
Shirley陈湘君 : 王爸爸说什么都对
可惜我是刘泽昕 : 男神！[色]
王哈喽 : [哈哈][哈哈]真的是太他妈操心了！！
崩擦啦滴答噜 : 差不多得了啊，别没完没了的[笑cry][笑cry][笑cry]
回忆的老照片 : 日本终将灭国[doge]
Lionel走过的十年 : 外面的有完没完了？
牧_之_ : 表白外长大人！！！
瑜一梦 : 帅气的外长大人[求关注]
掏出小本本 : 在国际法里，这种声明并没有法律约束力，跟之前的宣言一样。
滔滔的卫生间 : 我已经被王毅大大深深折服
石头8哥 : 王总举手投足之间都有大国风范，依然那么潇洒，支持王总的点赞
胡图图同学啊 : 王霸之气
TouchSkyline : 日本就是美国牵制中国的工具
我有一个仙女棒ovo : 这个手势是：卖av的请别多管闲事[doge]
童颜散人 : 请西门大官人不要没完没了！再找我家金莲了！我！我！真打人呐！[哈哈]
Berry-be : 我单方面宣布这是我爸。
向沐宸 : 王毅娶我[心][心][心][心][心][心][心][心][心][心][心][心][心][心][心][心][心][心][心][心][心][心][心][心][心][心][心][心][心][心][心][心][心][心][心][心][心][心][心][心][心][心]
诞诞诞诞诞 : 男神说的对
家里有只刘小宝汪汪汪 : [鼓掌]
V吴记麻辣油 : 男神！
AQ简易时光 : 这真是没完没了你，小“日方”国不大心不小啊[鄙视][鄙视][鄙视]
浮夸inginging : 男神
白裙_ : 帅爆[羞嗒嗒]
大航姐_HHH : 对呀贱皮子别没完没了的，外长大人好帅啊哈哈哈哈
YXY不服气打我撒 : 别没完没了[爱你][爱你][爱你][爱你]
CHENchen陳陳陳陳 : 中国爸爸就是强
雨儿秦 : 王部长帅呆了
欧豪1992_梦冉 : 王毅超级酷[害羞]
GD_yanglin0913 : 日本怎么不灭国啊
Catherine_Sui : 真是强行圈粉啦[爱你][爱你]
小小河v : 小日这熊孩子，真不懂事。
臭元的萌川川 : 王毅部长:爸爸好生气！爸爸快要保持不了微笑了！[哼]
RilkeanHeart7 : 王毅大大是自己男神 同意的右上角[赞][爱你]
mrdaods : 看见男神就点进来了
汐盐甜 : 大赞！
ZzzzzwHhhhh : 虽然很霸气 但是你讲几句话人家就会理你了？
突击小分队啊 : 日本一边玩去，中国不屑与你交流
那sei家的女王陛下 : 没完没了了还！
飛沙揚礫_ : 真他妈牛逼！五体投地！[赞][赞][赞]
曼玉最棒 : 男神
HelloArui : 男神[鼓掌]
荞荞又不胖 : 看见祖国这么直白我也就放心了[喵喵]
酱小酱_koni : 日本是不是别有所图
Dhvkna : 小日本[吐]
陌墨尘上 : 我男神的消息，一定要赞[微笑]
青春短句 : 赞我有100块钱领，赞了就关注我，给我私信[心]
大概是一只咸鱼 : 我们部长意思就是：别给脸不要脸[喵喵]
再见瑞卡巴卡再见 : 王的蔑视[右哼哼]
刘阿欣欣欣欣欣欣 : 没完没了还[doge]
DSY的浅夏 : 不要脸——————小日本
最帅少先队员 : 再没完没了弄死你
木兰花落了 : 听到没[酷]
捉鸡逗逼 : 我单方面宣布王外长是我干爹[doge]
aigoalt : 劝了好几年了吧
暖阳in3 : 做的漂亮[强][强][强]
小季叔叔Yang : 丫考研我要努力去外交学院[妖怪]
别来无恙嵩在心上QAQ : 很强势！
梧桐叶落吾三生 : 不插手内政日本你不懂么？
羽熙C : 没完没了2333
moanLIU : 大叔好样的[爱你][爱你]
笑笑_Michelle : 一个字关你p事
wulikk安静的小号 : 硬气~赞！！！
M_员力_M : 王部长就是霸气啊[给劲][给劲][给劲][给劲]
SnoweirFu : 关你屁事@  日本
大钰小辉 : 王之蔑视
路过你的城荒芜了整个夏 : 安倍就是事儿多。[挖鼻]
一只没花鹿- : 我王爷爷最帅[兔子][兔子][兔子]
国民模范生 : 外交部长王毅，新晋全民男神[doge]
鹿不羁-7-FENG : 讲得太帅了，您就是我的偶像
APTX小哀 : 这个手势很萌[笑cry][挤眼]#王毅外长##给王毅外长点赞#
晴盈 : #良医好逑# 帅！
再见瑞卡巴卡再见 : 王的蔑视[右哼哼][右哼哼][右哼哼]
闹不住的八眉 : [好爱哦][好爱哦][好棒][好棒][好棒]
二月魚丸 : 真正的日本通
xmwz2012 : 日本的吃相是有点难看。[生病]
_______________一一 : 霸气[哆啦A梦微笑]
LS-zebra : [微笑][微笑]
365全死角女神经 : 外长大人！！！！路过外交部就想见外长。
寡淡清喻- : 他们还没完没了了 我男神说了 你们不要没完没了
博主未满18不给撩 : 王之蔑视[喵喵]
不二mmmmmmmm : 一个白眼翻死他！还反了他了！
Queenlinla : 真帅
不二家的牛扎糖 : 小日本真不要脸
一个神奇的人儿 : 王老板又霸气了[喵喵][喵喵][喵喵][喵喵][喵喵][喵喵]
青春短句 : 看我首页有惊喜
跨越阿尔卑斯山圣伯纳隘口的王子 : 听见没！别tm给脸不要没完没了[doge]
武青争青争 : 迷妹赞我！[微笑]
spinupkkkz__ : 男神霸气！
wenchiechshan : 别没完没了
艾景初夫人 : [推薦][推薦]
学数学的琪琪 : 霸气！
Seemann_ : 帅气
柳滴和1988 : 日本也是醉了，什么都想插一杠
这个微博名叫属于 : 然而
哥拿啤酒洗脚 : 666
Ge歌格葛各 : 我爱豆就是这么霸气[doge][doge]
too样图森破- : 6
-陈钰彬 : 真帅
你不用记得我的好 : 最帅部长[兔子][兔子]
