李蒙蒙-Confused : @送别乔任梁 
李易峰要亲亲 : @Lucky-小妞 @我是Teacher张
布姐氏_Z : 早点回来！
木槿夕颜77 : 07年夏天，天正蓝，风正好，你们正当时，可站在，我的青春走了
逆风飞翔的土狗 : @筱瓶子酱
金刚芭比-G : 心情好沉重，愿乔在天堂没有痛苦，愿剩下的三只好好的生活
JLJ小草莓 : @阿娇拉妈妈
哆啦Vicky梦 : [泪]
__森晨 : 徐璐不是唯一为他穿过婚纱的女星 他之前专辑里面一首歌的mv里面 糖糖也为他穿过婚纱的 这些都不重要 大家祝福他一切都好
dy389260 : 不受控制的哭了，这是第一次有这种感觉，好心疼，希望在另一个世界你能过的很好
我四lgy : 回复@陈waiting秦怡:哈哈，好吧
小橙199906 : 好心疼，天堂没有烦恼，一路走好！
东东枪的枪 : 总觉得死的不明不白
顾影自怜-独角戏 : 回复@霜儿-半颗糖:嗯嗯[泪]
霜儿-半颗糖 : 回复@顾影自怜-独角戏:同感[握手][握手]
huhu9191 : 看完全身起鸡皮疙瘩。。。我现在都难以相信就这样活生生的人就这样没了。。。真不敢相信这是真的。[泪][泪][泪]
任小语xy : 他只是去了自己喜欢的地方[haha]
冷憶雪Cdy : [泪][泪][泪][泪]
乔雪儿NMYSMKZBD : 看一遍哭一遍
老牛排小燕麦 : 博主请删掉 乔任梁根本没有和王子元合作过
驮着阳光的蜗牛 : 喜欢看你笑的样子，阳光帅气！得知这个消息很心痛[伤心][伤心][伤心]愿你在天堂过得快乐！
刘静文Mi : 看着看着就哭了，愿天堂没有伤痛，要做一个真正快乐的男孩
原来你还在这呢 : 别利用他来蹭热度，乔任梁和王子元先生从未有过合作，也从来不相识，我不知道这种谣言到底是哪一方传出来的，徐璐也不是唯一为他穿过婚纱的女人，他人已经走了，求放过。
淩濛沭 : 虽然没看过，但是那首光荣现在还在我坏掉的MP3里，走好，各自安好。
萌妹雨蝶_88 : 一路走好[蜡烛][蜡烛][蜡烛]
李喋喋的小师妹666 : 回复@林彬彬BRIK:2007年加油好男儿
雨晨花落寄相思 : 好可惜……
不明不白的黑白 : 看到他最后那一笑，眼泪出来了
顾影自怜-独角戏 : 在选秀结束后喜欢的李易峰 在这八九年里 也常常回顾选秀的视频 每当好男儿同屏都会莫名激动 还很期待四少合并 好男儿齐聚 这下 再无可能 一直也很喜欢痞痞的乔任梁 网王真人版 他也足够吸引人 安息。@李易峰 在这纷乱的世界里 不求你大红大紫 只求你安康幸福。加油好男儿们！
-我还能孩子气多久- : 图片评论 
就是要alin : 好多天没上网，今天一上微博看到乔任梁追思会吓了一跳。看完这个视频触到泪点。熟悉的歌熟悉的人。。愿天堂的你安好[心]
湛澈如希 : 这是我唯一看过的一季加油好男儿从此认识了乔先生
如此如若denden : 就是一直在掉眼泪 明明你笑得那么开心啊怎么就这么突然呢 其突然更希望你从来未活在聚光灯下 从来没来过加油好男儿 走你自己的平凡之路就好 这样你就不会突然选择离开我们了 这样的突然离开那不如从未相见 一路走好 kimi
金振萍2015 : 也许他的父母会后悔，如果不进娱乐圈，他平平凡凡的当一个普通人，也不会承担这么大的心里压力，也许他就可以过自己的生活。
Choizhing : @shybeeeeee
走太久会远吗 : 大半夜的又看到这个视频不是乔的粉丝之前也没有太关注他只是很喜欢我们相爱吧里他痞帅痞帅的笑可能我比较矫情吧这几天心情也不好总觉得他要是还活着该多好
J午夜阳光 : 他们是我初二暑假最深的记忆[心]
赵雅妮Ni : 哥哥的当爱已成往事
你de梅格妮 : 傻瓜有什么熬不过去的嘛！怎么舍得那么多爱你的粉丝朋友啊？不是你的粉，可是也哭了很久很久，不知道为什么[悲伤][蜡烛]
哆啦二代没有口袋 : 成长路上，我们都会走散[伤心][伤心][伤心]
江湖0809 : 我肯定不相信SM。喜欢想要一个人，可以利用权利去得到他，但搞死别人那非人能干的事！
孤独一个废物n : 啊心痛。
小宝家1991 : 心情难以平复，希望kimi没有走，开朗的大男孩[泪][泪][泪]
CobbleStone石 : 哭了
俊心永恒Polaris : @老王你说呢
-芠辣辣_Na-- : 你的笑好甜。
A画室过半生 : 回复@Dqingluz:脑莫神经病
冬菇是一只猫 : 回复@__小思思:[可怜]
__小思思 : 回复@冬菇是一只猫:看得泪目[悲伤]
妆后葵儿Avigers大区负责人任丽 : 越看心越痛[大哭][大哭][大哭][大哭]
Dqingluz : 回复@A画室过半生:你才神经病
yumim7 : @MilimiliaMii
别爱上这样的女子润 : 郑州手机分期0首付。够18即可。苹果，三星。卡西欧。美图。郑州实体店办理。当场拿机器，国航渠道价   
想做学霸的小璇子 : 回复@Bn沐沐:[悲伤][悲伤]我也感觉他挺好的~就是性格直了一些说话也直白~现在的人真是虚伪的听不来实话了。
张纯纯Ccz : 最贵的你走了
美兮丶c : 別點 
A画室过半生 : 回复@Dqingluz:你是不是有病啊 你就那么希望乔任梁死吗？
志啟永在 : 好难过，逝者安息，愿在天堂快乐[祈祷][祈祷][祈祷]请那些无聊的不要在打挠了，让逝者有好吧
Bn沐沐 : 回复@想做学霸的小璇子:刚看到这个视频，那么好的一个孩儿，怎么说走就走了，一定是去了干净美好，没有黑暗的天堂[泪]
阿胖是雷锋 : 只希望乔任梁能像沉珂一样
十年多久我们陪你永远 : 回复@Fancy-小花:我……不知道！不过我希望这只是一个天大的玩笑！求他回来！虽然是路人，但听他的《复活》我哭了N遍！
那年夏天遇见T : [蜡烛][蜡烛][蜡烛]一路走好
TinyTint : @Xy小羽小羽小羽
喜欢你如太阳般温暖 : sm是什么意思呀
JessicaTTW1213 : @presistent819
小布丁的大熊麻麻 : 王子元发公告说他不认识乔
吃货小宁打扁Boss : 笑起来很好看的大男孩。。
六快拨 : 多希望明天早上看到乔任梁发博：昨天说我死了的？我竟然不知道
你任性的小公举 : @五花肉呵呵
__咕咕i : 我想看倾城四少再合体[悲伤]
小喋喋啊 : @王炸儿了
只为梦初 : 那些诋毁过他的人要记住，他有今天这个结局，你们也有一份功劳
玄女QQ_ : 回复@夏氏榛果:我已经两天没睡好觉了……[黑线]
国际易经星命奇门风水大师曹璞 : [蜡烛][祈祷][蜡烛][蜡烛][祈祷]人的命运呀！[蜡烛][祈祷][蜡烛][祈祷][蜡烛]#风水改变命运，八字预测人生，易经指点迷津，奇门化解灾难，六壬趋吉避凶，流年不利可占星，好名字就是好的开始。你知道吗？你的手里掌握着儿孙后代将来富贵显达的命运，积德行善吧！#
黑宝宝二彬 : 有些事情即使不愿去相信，但它真的是发生了。这就是生活，没有重播。一旦选择了，将无法改变。@乔任梁 永远爱你。爱豆。[爱你]
烊烊开心就好 : 这个视频真的好感动，光阴已逝，倾城四少再也聚不齐了，只希望还活着的人能够好好的，kimi一定会在天堂好好的[祈祷][祈祷][祈祷]
A后的菩提叶 : 窒息死亡
国际范016 : 越看越伤心[心碎] 
张牙牙42484 : 回复@skabs294:那是付辛博和井柏然唱的光荣
王monkey__ : 想回到小时候kimi还在的那些日子
苏打冰水 : 回复@神经衰弱加拖延症晚期: 我还记得当年加油好男儿的那几个人呢，好好地一个人怎么突然就……[可怜][可怜]
坦小克姐姐最爱你 : @River-牛牛 [失望]高中那会有一阵晚上在宿舍老听这首光荣。想想还是觉得好可惜
JING_LemonTree : [悲伤][悲伤][悲伤]
洋洋洋咩咩咩咩 :  看大片[害羞][lm挖鼻屎] 
洋洋洋咩咩咩咩 :  看大片[害羞][冰棍] 
天津大学考研网 :  看大片[害羞][din挂了] 
手机用户3135482091_713 : 回复@社交自媒体:你有病吧，心理不平衡的是你吧
Laure三哥星人22 : 很突然 一切都太突然。就像你突然离开这个世界 不知所措。也许那里更适合你 至少你不会累 只为你祈祷[蜡烛][蜡烛][蜡烛]乔任梁。
少女心太野 : 我不是他粉丝，可是我真的为了哭了，好难受
天津大学考研网 :  看大片[害羞][黑线] 
蕾拉小草 : 回复@Dqingluz:一万个同意[泪]
晶晶_晶晶姑娘 : 小白你必须好好的！必须好好的！
我是一只会唱歌的猫 : 峰峰 么么哒
乔任梁我等你下一次出现 : 乔任梁，下辈子做我一个人的男神好不好。(原谅我的自私，只是不想你在受到伤害。) 乔任梁，下辈子不要这么累好不好。 乔任梁，下辈子让我早一点认识那个爱笑的大男孩好不好。 乔任梁，下辈子......     乔任梁，他们都说你走了，可是我不信，你一定是累了，所以想换一个身份了，对不对。一定是这样的。
牙撸酱 : 亲爱的kimi，你在比赛时的古装很美知道吗，你坏坏的笑很迷人知道吗，网球王子你不是主角可是为了能看到你我每集都看就怕错过你。你不该这么早离去。只愿天国没有舆论没有压力[心]我会哭很久很久，但如果那是你喜欢的选择我尊重你。
艺名启迪 : 岁月无情人有情#诗意之意#
素年zll : 加油诅咒解开 ￼网页链接
思颖Rumors : 别点 
七的旋律 :  看大片[害羞][哼] 
白白鱿鱼sir : 要是李易峰出事 我感觉我会爆炸！
UrbabyCHEn : @52MJJ
诗人的情人__ : 此间再无倾城四少[泪]
0吾心 : 还那么年轻[悲伤][悲伤]一路走好
么么小新新 : 哭了
BCBC04 : 尽管不相信这个事实，但爱你的人是不会在意你是否远走，依然会记得你的好[泪][泪][泪]
陈二狗dc : 太可惜了……不知道说些什么。只希望他可以真的解脱，不再痛苦。[微风]
小菜鸟要加油 : 红了眼眶 想起了许多过往 那时的我 那时的你
单纯幼稚君 : @热血少女的梦想 这个[泪]
Ethel叶苏雅 : 看到这个真的有点难过了[悲伤]
王不着调 : 回复@郑州大学城儿:不用跟这样的人较真 他可能真的看不见 毕竟心里有什么眼里才能看见什么
Evan_蔡蔡蔡 : 忍了两个晚上的眼泪看到这个视频终于泪崩了
莫_醒_醒-2 : 看了好多遍，看哭了。倾城四少再也回不去了[悲伤][悲伤]
R-X-R新 : 不敢看 我怕哭[泪流满面]
欣麗蕭 : 真的好難過 多希望不是真的[悲伤] kimi[祈祷][祈祷][祈祷]
ZH橙宝宝 : 失去了才知道重要性
七号少鹿 : 回复@-陈志坚:有病
-陈志坚 :  看大片 [发芽] 
航-rukia : 一路走好。
没准我已经睡着 : @啊烨烨烨烨烨
一只海豹酱 : 看哭了，记得播好男儿时我还在上小学，还为乔任梁投过票，曾经的我也是一名抑郁症患者，完全可以理解他的痛苦，虽然惋惜也尊重他的选择[祈祷][祈祷][祈祷]
Seolhee- : 乔任梁真的很可爱很活泼一个男生啊 怎么会这样 看着他们四个如今发展都很好了
莫_醒_醒-2 : 现在说什么是不是已经晚了，看着这一幕眼泪盈眶了，满满的青春气息，时间匆匆
四月里的皮皮 : 光荣，我的童年，第一次总有复读机，听得第一盘磁带，还是她买的，物是人非事事休，欲语泪先流，怀念他和她。
莫_醒_醒-2 : 那一幕如有人问他，如果四个人能同台拍一部剧，Kimi说的是什么？
CC-詩児 : 初中那年他們一起出道，不好容易這幾年大家都開始越來越好，乔卻先獨自離開了。真的好難接受！[祈祷][祈祷][祈祷]一路走好
洛见清 : 别点 
BigBigBigsnow2 : 感觉怎么都无法相信。
WMERSUMZ : @_麋鹿怪兽_
乐观的李铁柱 : 厦门台风你们不关心，无限制的刷*?で，*，看我表情[微笑]
有毒的微博什么鬼 : 你的笑容融化的我那乌云的心 ，好可惜，一样你在天堂好好的
陶子美瞳购 : 其实他笑的时候真的很好看。像孩子一样。
爱吃火锅的熊喵 : 看过去年的我们相爱吧或者对他有些了解的人，应该觉得震惊的是表面上那么乐观积极温暖高情商的人，内心竟然会是那么痛苦，会以这种方式离开。无数失眠痛苦的夜终于不再困扰了，愿安息。
刘书佳咩咩 : 喜欢你坏坏的笑，真希望明天早上醒来看见你发微博说，我不过是睡了一觉怎么有这么多的信息，
魅惑mm丶馨妹 : 愿逝者安息
bcfbCLH : 为什么李易峰比他火。
大米饭的小米粒 : SM?韩国的那个娱乐公司吗？
TOP我男神11 : 娱乐圈的水不是一般的深
小胡胡06 : 走好
怀念你掌心的温度丶 : 希望脑残粉不要道德绑架
倔-------- : @呓语阿嚒
洪梅君 : 一路走好[蜡烛][蜡烛][蜡烛]
卡卡卡卡皮卡皮卡_七 : 一个喜欢的明星突然一下就没了以前他笑的多开心  感觉真的想去好好珍惜现在的每一天了  生命说没就没了开心过好每一天
暴走miss玬 : 还是不敢相信[悲伤]
赫鲁小丁 : 这个太虐了[伤心][伤心][伤心]@月夜呼啦啦
vv宝宝vv521 : [爱心]️
草莓味的JungKook : 一路走好[蜡烛][蜡烛][蜡烛]
张大浪- : 真的，不太敢相信，
张大浪- : 不太相信
南方姐姐L : 只想说两个字 有病[吃惊]
-苏苏--__ : 想说是是非非能不能就随他去了，这样有意思吗？别再扒这些了，让他家里人怎么承受？已经承受丧子之痛，今后还要听到别人议论他儿子怎样怎样？[悲伤][悲伤][悲伤]
ayan923 : 剧本都写不明白 拍nmb啊  ？人都没了还逼逼叨～
咖啡淼 : 他不是因为网络暴力才抑郁的，而是剧组的压迫和诋毁，以及经纪公司的压力
阳光男孩我乔 : 不想骂你俩，给你俩脸了，要骂你俩，也就是时间的是，我们VIP都是爱乔的，你们是害死乔的凶手之一，你俩真他娘的没爹，卧槽，气死了，你俩赶紧死去，不想在听见在看到你俩的名字，封杀你俩，大爷的，死没爹，还我乔任梁，
Yuu_il : 突然觉得素质差的导演和素质差的驾校教练一个德行，知道一味的辱骂，在任何一个行业还是要有最起码的素质和教养，对要人有起码的尊重，人都是平等，暴力语言对人心灵伤害很大。
slaowkdidn淡淡的 : 越骂不是只能越把他推到热搜吗？为何不一笑置之呢？为什么不消停会呢？让逝者安息，让借机炒作的人无法炒作呢？心里默念、心疼！去年安鈞璨已经让人惋惜了，今年多了个乔任梁！感觉英年早逝，真的很痛心！无论是谁，是否明星，只要是人，英年早逝都让人心疼，因为人生才刚刚开始，却只能选择结束！
蛋糕K一壳 : 不是说不要网络暴力，而是要文明地网络暴力[微笑]对于这种压榨演员，还诬蔑演员的导演，有什么好原谅的[微笑]
双子座小雨点 : 还我kimi 不管怎样[悲伤][悲伤][悲伤][悲伤][悲伤][悲伤]
Ya不二 : 你们双方难道问心无愧？
卺不服是一种态度 : 就像梦一样的，一个人就那么离开了，是不是应该反思，自己的话对别人的影响多大，没办法去说，就不应该安静，还故去的人一片安宁的天空么，愿kimi的世界有粉色环绕着
dgjkskh : 封杀这些导演。
vivi自己 : 我刷微博真的不想刷他的消息了，人不在了能不能安静点，娱乐圈那点事有必要吗？
夏至未至1324 : 既然网络舆论暴力这么厉害……喷子们可不可以干点正事，让这几个导演知道知道什么叫做舆论压力呢？[微笑]
他cads : 她妈的你智障吧导演，好烦你们，有必要吗
zyyt王倩 : 这种人也配当导演也配当理事[微笑]不把人当人了是吧，人才刚走，不能消停一点吗[拜拜]
温稳小林童鞋 : Kimi一定要狠幸福，无论在哪里，现在一切与你无关，你负责笑就行[爱你]
温稳小林童鞋 : Kimi一定要狠幸福，无论在哪里，现在一切与你无关，你负责笑就行[爱你]
Luckyboomm : 你们没完了！
手机用户2626243203 : 越看越难受
日日醉凉州 : 死者为大[蜡烛][蜡烛]
林修恒 : 太可恶了
小肉圆滚滚V : 人都没了还说说说 这些导演就不能闭嘴吗
爱左戴的瑶瑶 : 这样的导演，拍出来的东西能看嘛，果断拉黑……辣眼睛
zhanglipinger1 : 没听过他的歌，也没看过他的戏，只是知道有个人叫乔任梁，可看到他去世的消息，我却哭的稀里哗啦。最近微博关于他的热搜，我一个也没敢打开，或许说起来很矫情，可是真的，一看到关于他的消息，我就很想哭。
桃花侠-大战-小日本 : 我只想说，他妈逼！什么叼导演，什么叼剧组[斜眼]
o3o可爱混蛋 : @G-雅LH-7 @Verbal_Jint
Icanbexxxxx : 都别吵了，很烦，让他安静地走吧[悲伤]
跟俄走吧 : 不会看你们拍的电影，甚至连你们是谁我也不知道
淡情弦 : 干他丫的！
佑熙后边的英文没了 : 真的好心疼[悲伤][泪]
佑熙后边的英文没了 : 真的好心疼[悲伤][泪]
Vita月 : 导演人品有问题…
x-Toxic : @GUCHUNYI-
一只一大口 : 呵呵呵 这种人迟早下地狱 没得说的 坏事情上天都看着的
苗苗的鱼鱼wygg : 导演真是下贱！这种人就不能有一点小权利！马勒戈壁可上天了，不知道自己是老几了
凭海临风1025 : 人都走了还要炒作，也怪有劲儿的。赖上剧组了吧？
叛逆的老太太 : @OoZXIN
happyvirusCY : ....ㅠㅠ
喜欢微笑的人鱼 : 报应和惩罚来自于自己的内心，而不是外界。坏人永远不承认自己的坏，他们把所有怨不满负能量和自私的本性转嫁善良和弱势群体，所以他们不会抑郁更不会有负罪感
只爱kimi永远的vip : 上帝嫉妒善良的人 把恶毒的那些留在地球上继续害人  抵制其作品
被遮掩的沉默 : 太过份了，好心疼乔任梁
闪闪发光的神经颖 : @_Vicwanan
烊烊的姐姐angel-wong : 感觉那几个导演也不是什么好人。
曾经模样小小的你们 : 都过去了，何必呢，他现在在他的世界一定很好
王泽华___ : 进了剧组得了抑郁症…真的心疼[悲伤]
仙后的衣橱 : 想到了当年王家卫是如何折磨哥哥的
吃饭爱你两不误 : 这导演真是，mdzz[怒]
这条小鱼在乎-f : 好心疼他[失望]
合肥纯女子街舞工作室 : 不乱说话，免得被人说网络暴力，但是，说假话的请原地爆炸！！！
想叫什么叫什么嗎 : 垃圾人，你死吧，换回kimi
阳光男孩我乔 : 车经行，杨文学，记住你俩会死的很惨，我乔会报仇，给你托梦的，哈哈，祝你早的癌症早点死，什么血管病，什么肿瘤，什么脑血管，哈哈，各种，死的种类多着呢，看你用那种方法死吧，你俩害死乔的，你们会生不如死，死了也让你下地狱，活着也好，死了也好，都不会放过你，菩萨开恩[祈祷][祈祷][祈祷][祈祷][祈祷]
Luck_Girl婷 : 入土为安的他还被这般污蔑，可恨！
Se7ennna : 人在做，天在看
腻腻-酱 : 来人把这个导演带走，祝导演一路走好
Se7ennna : @想叫什么叫什么嗎
奔跑的陈皮皮 : 尊重演员。基本责任。而且你们明明知道乔任梁有抑郁症，因为什么？自己想想？冯小刚导演有这样？其他更加一流的导演有这样？不是一流的请不要在这里装一流了！任何一个明星，踏进娱乐圈，不是被你们羞辱的呢
韵ma : 杨文军是谁啊？
我是你小姐姐啊鹿 : @JULY_MTN  心疼
nicle小林哥 : 可是我想说 经济公司难道不过分么？明知道乔这样，还让乔接西啊？你们不应该只骂导演啊，我觉得导演经济公司都不行
强罗彻哟 : 谁都不知道发生啥了 就开始喷上了 小心打脸都
犹然佳晨 : 别吵了，让他安静的走吧[祈祷][祈祷][祈祷]
绮男阿 : @一个没有脾气的小孩
Crazy--孟娇69301 : 没能耐得破导演。没人性。
粟深婷 : 人贱自有天收，人问何时收，天回即刻收！ 另希望kimi在天堂能开心，下辈子别做演员了，只希望你能平平安安的活一辈子，再也看不到你的笑[大哭]作为一个路人觉得心里很难过
平生未囍 : 这俩导演谁啊听都没听过[微笑][微笑]
子豆非咖 : 怎么转发不了
real果果galaxy葛格 : 生而为人  善良一点。真的  这个世界上  鬼不可怕  人最可怕。
魏极鲜 : 是  人演不好  你他妈演啊  不看看自己长的什么样。。。有脸说别人  该死的是你
Carooool_15 : kimi到底经历了什么[泪][泪][泪]心脏疼…
烟火里德尘埃 : 封杀这个导演吧，不想骂他，只是看在乔的面子上，这种人，这辈子的戏我都不会看，不过，人在做，天在看，自己做的事情。终归是有报应的，反正今后你和乔也不会相见，毕竟一个去了天堂，而你，终将会下到地狱！！
夏舞123 : 真心疼乔任梁，死导演，赶紧去死
甲子年的米妮1981 : 不好意思，杨文军是谁
魏极鲜 : 不得好死的烂导演！不配做人！
魏极鲜 : 杨文军混蛋！！！
涂小花tu : 如果都多一点人性的体谅，宽容结局还会是这样吗
涂小花tu : 如果都多一点人性的体谅，宽容结局还会是这样吗
贝贝5556338026 : 演员也不容易，合理安排时间最好，身体比钱重要
水近夜空 : 杀人偿命。把人家儿子逼死，不是可耻 是该死！另外400个导演同意不同意?[哈哈]
沬凡 : 一看就来气，撒谎都不知道羞耻！别想我掏一分钱，看你拍的电影！[拜拜][拜拜][拜拜][拜拜]
多多洛_智久哈尼酱 : 不是要封杀嘛，能封杀的，只有广大网名，大家联合封杀这导演
艾琳MIN : 多说无益！乔，以后的日子你好好的去旅行！JGD[祈祷]
女王心妹子脸 : 回复@LH7-思狍鹿心:他们只在乎能带给他们最大利益的人的健康把其它小演员都当成什么了，不想说了越说越气，乔又回不来，  特别是那个说他磕药什么的那个人，看他当时发的微博不吃饭不睡觉不离组陪你们干那个好像他心脏都不太好，吃速效救心丸，看的我心酸，每天都在想他到底经历了什么这么年轻就……
cuicui_happy : 不信抬头看，苍天饶过谁
周小八是花花 : 是你们害死乔。
张琪琪琪y : 心疼kimi，一路走好，愿天堂有你爱的音乐和粉色。
大耳朵小小徐在哪里呀 : 回复@Mandy-蕾蕾酱:这样的导演
晚上不要睡 : @要早睡多喝水 什么鬼导演，去死吧
曾玲莉frv : 心疼
阳光男孩我乔 : 麻蛋的，做个导演能了是不，看你死了是不是下地狱，告诉你俩你俩就是杀人犯，你的忧郁症了你是不是活的很潇洒？等你家死的时候，记得通告一声，让我们知道你死了，让我们VIP心里高兴，老不死的，你会死的很惨很惨我乔会回来报仇的谁害死他的他都清楚，他为什么离开他自己也清楚，你俩会死的很惨[哈哈]
长岛冰茶-blue : 那个导演，妈的 组队去打他
李嬷嬷是矮子 : 我只想说，好人品的人一般不会主动到处散播别人的不好，更不会在人走了之后还要叫嚣。有点欲盖弥彰的意思。
李嬷嬷是矮子 : 我只想说，好人品的人一般不会主动到处散播别人的不好，更不会在人走了之后还要叫嚣。有点欲盖弥彰的意思。
用户5624050856 : Kimi我好想你  真的不愿相信你的离开 不愿面对  去年看相爱吧笑看的觉得你是一个很浪漫很温暖的人 现在很想看却又不敢看  刚才看了一会又不敢看了很舍不得都是一边看一边哭[祈祷][祈祷][祈祷][祈祷][祈祷]  你没有离开一直都在是不是
孟婆我要出国 : 麻蛋
偏爱阳光Lily : 不是乔的迷妹，但是特别可惜，也是一路看他从好男儿走过来的，真不愿相信他离开。请让他安静离开，所有是是非非请远离他。
蒲素想去旅行 : 让他安心的走吧，人都不在了，这些事都过去吧，求你们了
只想和你好好的SZ : 感觉完全就是被他们逼死的！经纪公司和狗屁导演！
好吧我是黄梦洁 : 回复@巩玉倩:感觉什么隐情要被曝光了
井姐二 : 把他封杀吧！人品如此之人，何以导剧！
哈哈你是对的xixi : 太坏了，这导演！虽然靠明星挣很多，但也不只是赚钱的工具！心疼乔～[泪]
Ms_Wenjun : 哎，导演这也太恶心了，kimi一路走好
-鸦KARAS- : 都走了还要被缠着八卦新闻也是无语啊@嗜肉兔星人丶
关于你63190 : 都把他逼死了还想要怎么样
陪伴与长情呀 : 这种导演 不看他的剧
溜溜小粉丝 : 人不在，我们的心里还是有他。你们人还在世，却永远走不进别人心里！拍出来的东西，有人看吗？
思杰airen : 求艾特名字 去骂死这些狗导演
黃纟彖纟彖 : 垃圾导演，就这样还能做导演，吥演也罢！
杨洋icocf : 這人，，，，，以為是導演了不起？兇手
杨洋icocf : 這人，，，，，以為是導演了不起？兇手
kisses鱼 : 好心痛哦～人都走了，请不要再折磨他了，[泪]
lena_王特土细游 : 去死
思杰airen : 我想干死这些剧组的人[怒][怒][怒]抵制！
VivianLuo_ : 心疼
Nicole-W : 善良的人才会被你们欺负成得了抑郁症，现在人不在了，这些导演说来干嘛？抵制这些导演的戏
Du_Lyan : 不管之前是怎样，不管之前谁对谁的错，但是kimi已经不在了，就不能让一个逝去的人安静的离开吗？就算之前得罪了谁谁谁，那又怎样？现在说这些有什么意思？？？
-费雪小海马 : 杨文军是谁 车什么玩意是谁？
巩玉倩 : @好吧我是黄梦洁 @徐谨不是徐瑾 撕逼了，人性真可怕，入土为安这都不懂
民欧洲 : 狗导演
蓬蓬lay : 所以你们是他去世的一大推手？[泪]
这就是我噼里啪啦 : 狗日的导演，玩蛋去吧
无惧城堡之外 : 封杀导演，有没有人列出一个这导演要上的戏？坚决不看
二路青年 : 抵制把
噗噗叽- : 人都去了 尘归尘土归土的事 还这样诋毁人家才是见人品！！！
噗噗叽- : 人都去了 尘归尘土归土的事 还这样诋毁人家才是见人品！！！
Miss_____Anna : 这什么公司哪个导演来着？人刚死说这种话，活着的时候你怎么不点名？以后他们的电影我绝对不看
ddyucdhbft55388 : 我觉得全中国都应该封杀杨文军，
Lin_Yao_YYY : 心疼乔[爱心]为了你跟杨文军车径行死磕到底→_→你们两个是不是制杖啊逗死人头七后出证明表逗了干嘛不头七内就出证明啊是不是不敢噗逗乔粉吗[哼]智障
我叫余春娇 : 鄙视！
墨尼黑司机 : 在的时候黑的黑，不黑也都搁着，现在人没了不管哪路人都来借死人的名头积赞积粉，各种发人家的生平事迹蹭热搜，能不能让别人死得消停点[微笑]
木木夕shine : @Adrian273
我是不二君free : @景小罗
一个不会骑扫把的胖女巫 : 他一直很敬业，他爱的音乐，爱他的工作，为什么要被这种所谓的导演诋毁成这样？！好心疼他！[泪]人都走了还不放过！还在推卸责任！这样甩锅，良心何在？！就没有一点的良心不安麽？？？
猫巷女王i10705 : kimi 💕
A二七女神超市 : 愿你在天堂好好，那里有一方净土，永远爱你
夏季百年草 : 回复@橙小橙再见:说别人是杀人犯要有法院判决的。
孫悟悟悟 : @瓶子里有雪
我和小外甥的日常 : 人间太黑暗[祈祷][祈祷][祈祷]
初心蔚变 : 看着就来气，他受了那么大的委屈还不让他安宁，导演的良心被狗吃了吗
璐璐哒小魔仙 : 不要再吵不要再撕了，就让他安静的走吧……
cc是kmoon : 妈的 现在人都走了 还说什么呢？心疼
凹呆立鹤本 : 借着过世的艺人继续炒作就是这位导演的人品了 这种人会导出好片子吗？说难听点你就是推了kimi最后一把的那个凶手
我的半路出家的猫才真宗 : 那两个导演是谁[挖鼻]
散浮华 : 还是忘了这一切吧，重新开始吧，做个快乐爱笑的普通人
Miss_宋彦莹 : 该骂的人就得骂。
哆来咪发嗖啦唏- : 对待工作一丝不苟的他却被你们的言论生生给掐死，导演？呵呵....滚吧[微笑]
Miss_宋彦莹 : 这个导演才该被封杀，没人性，拒绝看他导的片子，都是用演员的血泪换来的，希望再也没有演员和他合作了。
跟馬搖滾學吉他 : 他还活在我们心里[蜡烛]
Khun家女 : [祈祷]走好
坚强的丹小丹 : 真的是太心痛了 只有28岁 是谁说的悲剧就是把美好的东西破坏给人看 他的生命那么美好 笑得那么好看 所以我们不要去随便评价一个人 为什么kimi的离去会这么震撼 是因为从外在谁都看不出来他的内心原来那么痛苦 是的 即便如此 居然还有人恶意造谣 也不知这些人的良知何在 愿这个美丽的生命在天堂快乐着
妞-3- : 我好希望这一切都是假的，我也希望几年后，甚至十年后你再出现，只要你还活着。离去得那么突然，你让我们怎么办，怎么能接受！我一点都不想祝你天堂安好，因为我希望你还在这个世界，哪怕退出娱乐圈，哪怕以后再也没有你的消息都没关系，只要你活着[泪][泪][泪][泪][泪]
dayvera : 我还是不敢相信[泪][泪]
Shelly之 :  [给力] 
有一句应该说 : 愿任梁哥哥在粉色天堂被温柔以待。[心]
戏先mrgamer : 再见，我很想你。[蜡烛][鲜花]
吖狸说到坎里的话 : 恭喜爱酱喜欢这一对[爱你]
Theclever : 不要再伤害他了。kimi一路走好[泪]
我妈来自异次元 :  [cai奸笑] 
牙尖的木头人 : 走好[泪]
吖chenha : [蜡烛][蜡烛][蜡烛]
時而- : 追思会都是给活着的人办的
谷谷Lee : [蜡烛][蜡烛][蜡烛]
豆拼拼_ : 看到后眼泪还是噼里啪啦狂掉，，，[泪][泪][悲伤][悲伤][悲伤][悲伤]
秋达降措_编 : 压死你的最后一根稻草到底是什么 在你弥留之计你是不是后悔了想要努力的活下去 可是你没有了力气 你慢慢一点y一点沉入黑暗失去知觉再也没醒过来 我多希望十七年后能在某个街道遇到一个跟你一样笑起来坏坏的漏出虎牙的大男生 我一定给你一个大大的拥抱 然后说 好久不见
花蝴蝶93 : 一路走好，活着的人要珍惜生命。
这样不好吧安安521 : 一路走好！既然不能挽留那就尊重你的选择。愿在天堂过的快乐
lYKa_ : 虽然不是他的粉丝！虽然一开始看我们相爱吧对他没好感！ 但是一直在众人面前的微笑让人印象很深 ！新闻出来的时候第一感觉是假的！然后陆续的发悼文！公开承认！才相信真的去世了！直到今天！看到这样的灵堂！心中一触！kimi真的离得已经离去！很悲伤！永远的阳光少年永远年轻！一路好走[蜡烛]
Kyle韜光養晦 :  [lxhx病了] 
林荫斑斓 :  [圣诞帽] 
周新凯0305 :  [lxhx喷嚏] 
Shelly之 :  [ppb奸笑] 
hhhhHENIMA_ :  [ala上火] 
妮儿想倪了 : kimi，希望你一路走好！愿天堂的你永远快乐！你永远是我们心里那个阳光、帅气的大男孩！🕯🕯🕯
九又之秒小萌汪 : [蜡烛]
小小葫子 :  [km花痴] 
ReactNatie : 惭愧已经没有用了  即使不喜欢也不能诋毁  这是对一个人最起码的尊重
温柔大眼睛甜心 : 转发微博
PHZT_ : 他还活在我们心里[蜡烛]
鲸鱼专用小马甲 : 一个年轻的生命就这样走了...我还记得我第一次看他录的节目，当时觉得他的长相真的是惊为天人。希望天堂没有抑郁。走好[蜡烛]
幼大人 : 曾经喜欢有点痞痞的你，一路走好！
司玉亲 : 原来是个心机boy永远28岁的粉色男孩[蝴蝶结][蝴蝶结][蝴蝶结]
_酱酱__ : 真的好难过[悲伤][悲伤][悲伤][悲伤][悲伤][悲伤]
被菊花怪抛弃的桃花猪 : 他怎么死的！也没个结论
美美的冉冉 : 一路走好，惋惜。
断琴泣梦 : 再见，我很想你。[蜡烛][鲜花]
昆仑上的羊 : 压死你的最后一根稻草到底是什么 在你弥留之计你是不是后悔了想要努力的活下去 可是你没有了力气 你慢慢一点y一点沉入黑暗失去知觉再也没醒过来 我多希望十七年后能在某个街道遇到一个跟你一样笑起来坏坏的漏出虎牙的大男生 我一定给你一个大大的拥抱 然后说 好久不见
正经的坏学生 : 直到现在都不愿相信这是真的……
Amy_00823 : 我是BBF 却真实沉重的因为Kimi心痛了这么多天 一边刷微博一边哭 Kimi 从好男儿就认识你 这么多年 看你们各自努力成长到今天 真的很欣慰... 希望你可以找到你想要的自由和平静[祈祷] 记我青春的十年记忆 下个28年 愿你更加璀璨🕯️
pina- : Anywhere you are, I am near  无论你在何方 我都在你身边 Kimi
我是珊阿哥 : 真的很难接受一个那么阳光爱笑的大男孩就这么离世了。。。。
我是杨晓娴 : kimi,能否给爱你的我们都托一个梦，告诉大家你在粉红色的天堂里过得很快乐，好么？希望我的梦里有你，晚安~
蒂戈ThiagoMessi : 转发微博
怎么可以辜负美食 : 也挺可悲，活着的时候有那么多人骂他，不知道他，死了才知道他的好，但是有什么用呢？人都没了
LA_Troy :  [yz撒花] 
賭註_96630 : 嗯嗯
点点蹄点一口子sunshine :  [j] 
丑猫阿 : 几天了都[悲伤]一直忍着不敢相信没有哭[悲伤]可是看到这个[泪]就忍不住了[泪]
-寡人小黄 : 路人看了心里都一抽一抽的，粉丝怎么办[蜡烛]
blacklyness : 你带着我的青春，飞走了。愿你在天堂里继续开心大笑。我还记得那个夏天，和你，和你们在一起的日子。那年夏天，阳光明媚，
你长得像猴儿 : [蜡烛][蜡烛][蜡烛]
此微博已被盗用1121 :  [得意] 
aqiuO : 从此 他变成了不忍触碰的回忆 想到就心酸[闭眼]
泰AoMike : 还是觉得这不是真的 这到底是怎么了？
西西XiXiMom :  [黄牌] 
为了承诺不将就 : 虽然不是乔任梁的粉丝，但是看了真的好心疼，一路走好，再另一个世界或许就没有这么多的烦恼了
7viviW : 我不是你的粉，但从好男儿你选秀开始，就知道你，对你印象深刻，那音乐才华，那坏坏的笑，那笑起来微微倾斜的嘴角…看你时不时活跃在屏幕…可是毕竟你才只有28岁…一定是你和神灵在人间签下的契约期限到了…既然你只是履行约定…各么，阿拉上海小拧KIMI啊，一路走好[祈祷][祈祷][祈祷]
卢琼LQ : 数年之后还是会记住你的容颜，那个喜欢粉色的Kimi[蜡烛]
喜欢养披萨的女孩 : 希望天堂那里没有痛苦没有恶言，愿你来世做一个普普通通的人，开心健康就好[蜡烛][蜡烛][蜡烛]
tita球球 : 压死你的最后一根稻草到底是什么 在你弥留之计你是不是后悔了想要努力的活下去 可是你没有了力气 你慢慢一点y一点沉入黑暗失去知觉再也没醒过来 我多希望十七年后能在某个街道遇到一个跟你一样笑起来坏坏的漏出虎牙的大男生 我一定给你一个大大的拥抱 然后说 好久不见
ldd-bye : 走好。
A9-KONGKAI : 回复@骑驴找马ING:别说话 智障[微笑]
vovvivi : 一路走好 爱笑的大男孩[蜡烛]
梁冉冉冉冉冉冉 : 一路走好[心][心]
陕吃喝玩乐 : 惭愧已经没有用了  即使不喜欢也不能诋毁  这是对一个人最起码的尊重
wareyw :  [bed啦啦啦] 
你活小知识 : [伤心]心痛
三线有情况 : 太累了，你长眠在粉色花丛，把28年的鲜活岁月定格成一张黑白照片，人世间你来过，只是没来的急及说再见！一路走好，只愿天堂不再有红尘作茧，不在有长夜辗转，愿天堂风清云淡，你自由自在，笑的从容灿烂。
酱油打个桶 : 我到现在都不敢相信，太难受了[大哭]走好，逝者安息[蜡烛]
距离梦想的一步之遥 : [蜡烛][蜡烛][蜡烛][蜡烛][蜡烛]走好
VGirl-陈晓儿 : 回复@Renta66:现场也有白色  不过kimi更爱粉色
吴小蒙二号 : 走好[泪]
燕子酒 : 少点指责，多点理解，少点辱骂，多点关爱。易说难做，不要再让悲剧再次发生时，才懂得悔改反思，才知道呼吁。乔任梁 ，走好[泪][泪][泪]
貳見囍 : 一路走好[蜡烛]
MMG-宝儿慧心可儿的围脖小窝 : 乔任梁一路走好，愿天堂有你要的粉色的安宁！[蜡烛][蜡烛][蜡烛]
殇菸 : 该来的还是来了。[蜡烛][蜡烛][蜡烛]
qx55816 : 一路走好…太可惜了
疼爱是不讲理也让我几分ii : 即使哭到头痛  仍然坚信你未曾离去
我想你会愿意了解我Lsz : 从刚知道消息，到今天，七天了，刚开始的时候真的以为是谣言，是假的，可是越来越多的爆料，，，再看我们相爱吧，带徐璐回家那期，看到乔妈和乔爸，突然就哭了，感觉很心疼，很心疼！
遇见足够好的我 :  [无聊] 
爱吃美食的小元宵 : 走好  [大哭]
点小点miss_L : 一路走好[蜡烛][蜡烛]
几世有春秋 : 我是路人，都不能自已的哭了。为什么呀到底是为什么
牵挂着你1314 :  [g瀑汗] 
陈佳玲kiss : kimi永远爱你！好想好想你，希望你在那里好好的，最喜欢的那个人永远都是你
Jirichi : 一路走好[蜡烛]
小呀么小宁子儿 : 你终于可以睡好觉了，愿你的粉红色的世界里都是快乐[心]
落惜泽 : 希望你下辈子不再做明星希望下辈子你不会再遇那些黑心的水军。对那些言论攻击的黑心人真的是仇视到极点了，难道你们不懂一句话有时也会成为一把无形的杀人利器吗？一条鲜活的生命美好的年龄大好的前途就死在了这些人的言论之下你们难道可以就这样安心睡觉？心安理得的过自己的生活半夜不会被噩梦吓醒？
原善变也可以步步靠谱 : 一路走好 愿你在天堂找到真正的快乐
蒋淑玲- : 一路走好，感谢你来过[心]
小气包紫 : 一路走好乔哥[泪流满面]
