发是发哥的发 : [撒花] 
-蕾姆酱- : 回复@独醒的醉人:exo me？？？
林逸721 : 谢谢你带给我们的快乐，在那好好的！
璐邢 : 不想再看见陈乔恩的消息了[生病]
妹儿9999 : 一路走好……
大饼裹馒头 : 回复@she5822474823:对不起[可怜]脑子我有，但是不如你的多
快乐的小小凤 : [xb指指] 
宁馨儿zxn : kimi粉丝 她的生日再没你给的惊喜
张小彪他二姐姐 : 图片评论 
南和音 : 我也会把给kimi的爱 还在这个女人身上
LeisurePleasure : 7 years
小燃灬灬灬 : 回复@娜宝996:戳泪点啊[泪][泪][泪][泪]
寄雨声- : 回复@Miss曼芃:[伤心]
七七带你改变生活 : 回复@Miss曼芃:翻翻我的微博 或许对你有用
手机用户2889220951 : 好心疼[大哭]
wuli雯雯呀_ : 能够理解的[心碎]心碎，心痛
君令羽 : 发微博有那么重要吗？那些当初喷的人，扪心自问，你好朋友死了，你有心情发微博？再者，每个人表达悲伤的方式不一样，谁规定一定要发微博？人家发微信朋友圈不行吗？不发微博就要被道德绑架也是够了！
weixiao雯雯 : 回复@Kelly只是个胖子:对父母是报恩，而这些年他把所有的宠爱，都给了乔恩[伤心]
君令羽 : 发微博有那么重要吗？那些当初喷的人，扪心自问，你好朋友死了，你有心情发微博？再者，每个人表达悲伤的方式不一样，谁规定一定要发微博？人家发微信朋友圈不行吗？不发微博就要被道德绑架也是够了！
weixiao雯雯 : 回复@Kelly只是个胖子:对父母是报恩，而这些年他把所有的宠爱，都给了乔恩[伤心]
刘生粥 : 我怎么样才能把这个叮当送给乔恩呢？我从来不追星，不知怎么送。好心疼，一个那么要好的朋友走了[泪][泪] 
刘生粥 : 我怎么样才能把这个叮当送给乔恩呢？我从来不追星，不知怎么送。好心疼，一个那么要好的朋友走了[泪] 
韩梅梅男朋友 : 陈乔恩怎么又哭了，，，
若吾奇似 : 我看不下去啦[泪][泪][泪]很多事真的是无法挽回的  哪种无助
昵称总是被代用 : 回复@-尹氏杨总-:看到这句话真的。。[悲伤][悲伤]
Cri-爱硕的瑜儿 : 感觉大家真的好闲！
Princess宠宠 : 每次看到kimi的笑容都好想哭
燕子ne : 还是会忍不住去翻他们俩的微博，还是会忍不住……[泪]
-你你你你好 : 回复@Miss曼芃:啊  看完你这句  我又哭了   路人都看不下去[泪]
郭小雨-雨妞妞 : 回复@Miss曼芃:戳中泪点
爱鱼Crazy : kimi是爱乔恩的。一种我只愿在旁边默默守护你的爱。不愿乔恩受伤，自己生病了也默默忍着，不愿乔恩担心。除了友情，可能还是kimi默默埋葬起来至深的爱
meng5926674923 : 一路走好[悲伤][悲伤][悲伤]
花花找牙牙 : 一会说陈乔恩不发文表痛苦，一会又陈乔恩哭了，来来去去刷了几天热门，有意思？
Morning润 : 乔恩，加油。
布丁少女_Ether : 回复@青未秋分:点进去看了，很多人都是水军[微笑]不知背后操纵者有何企图
Ta是禽兽我深爱 : 回复@-尹氏杨总-:宠她七年啊  好久了[心]
土豆条7 : 回复@Miss曼芃:好难过啊这句话
用户5367859412 : 陈乔恩是应该反省自己，你要是多给他一点关系，也许不会到现在这步，去过得病得是你，他不说第一个知道，也一定会很快知道，他一定会无时无刻关心你，去照顾你，而你，是应该自问一下关心过他吗，他对你那么好，现在就算再难过，再后悔为了他也应该振作起来，，照顾好自己，多做些他为来得及做的事！
白羊春天丰胸调理助孕-羊羊 : 不愿意接受这个现实，多希望一切都是假的[泪][泪][泪][泪][泪][泪][泪]
小雅0720 : 我看完眼泪流不停，小时候就凭一部电视剧，爱上琉璃苣女孩，王子变青蛙，喜欢她到现在，就因为没有发微博被一些喷子狗骂得这样，心疼Kimi 心疼乔恩 ！ 愿逝者安息 ！
斯砌fyrea : 回复@独醒的醉人:对阿 毕竟你死了我们也没什么好怀念的[微笑][微笑]zz
老王家的小闹闹 : KIMI把乔恩明年的生日礼物都准备好了[泪][泪][泪]
刘李氏家 : 回复@青未秋分:道德绑架.她们的微博都未必发过只字片语
屁桃味的_無敵少女 : 扫码➕微醺就保证送到家 
xxxibgdrgn-Carol : 回复@Miss曼芃:这句话真的说的戳中泪点
兮柚n : 微博又不能代表一切，之前竟有人抱怨不发微博，抱怨他们的友谊不过如此，微博只是生活中芝麻大点的一个角落，竟有人把它作为获取价值观的唯一途径，真是有点，，，，
伴我多久到我白头i : 他己经走了，在也不能每年送礼物给陈乔恩的乔任梁
love梁山伯揍英台 : 虽然我不是你的忠实粉丝。祝愿你在那边没有烦恼！
Ta是禽兽我深爱 : 女神不哭    我们都在   Kimi一路走好
Ta是禽兽我深爱 : 女神不哭    我们都在   Kimi一路走好
情深i不寿 : 每天都是这货，这他妈的是谁？微博他妈的还能上？
小聪花ccccccc : 回复@青未秋分:中国网友已经空虚到把所有感情寄托给微博了
胡yele_Mr : 这么好，这么暖的乔任梁！这么好的挚友！[泪]乔恩带着这份爱好好的！
奔跑的三文鱼Jiang喵 : 多么有心的一个大男孩儿 哎
ladys噢噢 : 他一定是想好了要走了，才会把明天的生日礼物都准备好
别闹亲爱哒 : 去看了优酷全明星，从他说话可以看出，乔恩和他妈妈是他世上最爱的女人[悲伤][悲伤][悲伤][泪][泪][泪][泪][泪]
中药9玖瘦妙甄酵素Q糖招商 : 太可惜了。一条年轻的生命就这么没了。笑容如此阳光。内心却不知承受着多少痛苦，一路走好，愿你在天堂没有痛苦！
少女和猫m : 为什么没完没了得上热搜
听曼珠沙华的忧伤 : 虽然不是你的粉丝，但听到你离去的消息还是不敢相信，如果不是周边的人在讲你的离去或者手机里面关于你的消息我还是认为你一直都在。哥哥，一路走好，愿那里永无灾难，希望你在那边一切都好
奶茶-快乐柠檬 : 好好的
bayabaya- : 看到乔任梁早给乔恩买好的明年的生日礼物的时候真的泪崩了
张萌-RYR : 还是不敢相信这个年轻的生命这个大男孩离开了我们。离开了世界。只愿天上的他不再烦恼悲伤。
向日葵求好运___ : 放心走吧，以后我们挺乔恩
胜利__1104 : 看着心疼[伤心]
祝星__ : 回复@Miss曼芃:这句话[泪][泪][泪]
刘生粥 : 我怎么样才能把这个叮当送给乔恩呢？我从来不追星，不知怎么送。好心疼，一个那么要好的朋友走了[泪] 
茪輝岁仴0116 : 看着很是心疼，未来的路没有了好友的陪伴，好好的，乔恩！
可爱Recall : 人生的快乐和幸福不在金钱，不在爱情，而在真理。即使你想得到的是一种动物式的幸福，生活反正不会任你一边酗酒，一边幸福的，它会时时刻刻猝不及防地给你打击。[萌]345689123567902356780 
三亿丶少女梦 : 很多人很多事 只有在失去之后才倍感珍惜 这个世界上有太多需要装聋作哑的事情 谁都无法反抗生活 无法反抗无形的暴力 求的不多 身边的你们平安喜乐足矣[心]
--颜大大 : 如果不能悼念  那闭嘴也是一种善良    珍惜眼前人[悲伤]
永永永永永永小 : 不想听到天堂这两个字
施慧嫁给高煜_3107 : 回复@-尹氏杨总-:是啊！唉
我不信我的名字有重名 : 乔恩哭的必须带墨镜了吧
TVfXQandYOOGA : 回复@大饼裹馒头:乔恩前一天到的，机场穿的白色，第二天参加……穿的黑色，那两个字我不想说[悲伤]
太阳女神不森林 : 我姐姐意外去世的时候她多年的闺蜜来了丧礼。不吃不喝不睡觉哭了好几天。理解乔恩的心情。实在心疼
she5822474823 : 回复@大饼裹馒头:追悼时候都穿黑衣服，脑子是个好东西我希望你有[愤怒]
kiko不是kako : 路人粉哭惨了，更不用说那么好的朋友，男闺蜜，人心都是肉长的，好心疼[悲伤][悲伤][泪][泪]
我只是发表一下我的观点 : 回复@青未秋分:中国大多网友活在微博中，现实对他们太遥远
如果爱i请深爱i : 加油乔恩
W-baylee : 现在朋友圈到处都是一点小事一点情绪就发朋友圈 晒来晒去求安慰刷存在感 人家很多情绪不想说 低调不行吗
傲娇美少女lv : 乔任梁。一路走好
Mr_Jacky_Yuan : 心疼乔恩，陈乔恩是我最喜欢的女明星之一[泪]
雏菊花开的声音 : 哎可惜啊
时尚搭配Girls : 别说艺人，就算是普通的群众们看到乔任梁走了也难过，每看到一次，心情都受影响。
平平平pingpingping : 我看了乔恩写给kimi的，很难过很难过。
Simpleyyw : 他一直笑着，我们却忘了他也会哭，走好[蜡烛]
哦我的荷尔蒙大人 : 如果kimi能看到这个场景  一定会后悔离开这么多爱他的人
微语未然 : 回复@Miss曼芃:看到这句，泪目[泪][泪][泪][泪]
LIUJIAN瑜 : 应该立法打击网络暴力
涵曦小霖更多反馈视频加微信 : 怎么回事啊，
雪妹er_ : [伤心][伤心][伤心]这种感觉真的不好受啊[泪][泪][泪][泪][泪]想念kimi
青青雪斋 : 感觉所有人都在等她哭，无语
張曉曉曉Xia : 好心疼[蜡烛]
宜春搜才网 : 看着好心疼
未妨愁怅是轻狂 : 回复@Miss曼芃:瞬间泪目
屗肆 : [悲伤][蜡烛]
熏神染骨 : @哆啦a梦的口袋里是阳光
从小愿望剪短发 : 最后一张好心酸。[伤心]
疾风--劲草 : 没有道德绑架的真情才是真！
Molinsasa : 回复@大饼裹馒头:亲人的穿法先白后黑！乔恩把她当成家人
驹安保-智能车生活 : 回复@青未秋分:真正难过痛苦的时候哪还有心情发微博
七七带你改变生活 : 翻翻我的微博 或许对你有用
