LOVE-dongdong乐园 : 若川普做了总统，布什家族和克林顿家族就什么都不是了，因为川普跟他们完全不一样，他们代表的是个人利益，川普代表是民益@Markclothmap:   布什家族与克林顿家族轮流坐庄、独裁一体化，不太允许其他人染指，已经有了个奥巴马，怎么可能再支持川普~
我弟名叫骆福来 : 都退休了，他那一票其实也不算什么。看希拉里健康状况，他那票还真不知道有没必要投呢。
高筠霏 : 回复@Sylvainhuret:来给美爹洗地了？
夏日游风 : 回复@居越而思齐:虚假的总统竞选，就是几大政治家族轮流坐庄，没有外敌的时候假惺惺竞选，有了外敌一致排外，支持特朗普！
我改名字asl : 毕竟。。川普不怎么代表大资本的利益，，，无论是布什家族还是克林顿家族，，都是华尔街的绝对实力派呀。。。所以咯
坡上的阿西 : 特朗普是个剑走偏锋的狂人，持中庸之道的保守人士不会认同
啊广137 : 妄议在那？山头主义在那？团团伙伙在那？违反政治规矩在那？
天龙现爪 : 回复@甄芜缭:白痴
自然皈真 : 宁可把江山交给身体稍差点儿的正常人，也不能交给一个精力充沛的癫儿！
网络舆情观察021007V : 两个没落的贵族联手抵抗如日中天的新星川普哥，如同刘备联合孙权抵抗曹操，然而并没有什么卵用。
甄芜缭 : 老布什睿智英明[赞] 但他当年以愚蠢名扬天下的副总统奎尔宣布支持川普, 蠢货总会共振.
科技文化作家郑军 : 以前都说两党竞选是作戏，现在看来是真的。来了个局外人就把他们团结起来了[笑cry][笑cry]，
gablio : 儿子被虐哭[嘻嘻]
lawer_jun : 这不叫叛党，这叫治国理念不同
赛艇队员 : 会不会给人一种硬点内定的感觉？
吾立人群 : 为小儿子铺路了，，，
江山靖 : 希拉里如同老布什的干儿媳。如她当选，老布什当然会得利了。
武当觉微子 : 恨小布什和伊战的选民可以投川普了
天涯沦落客V : 回复@清晨的太阳668:伊拉克人民永远感激布什家族，否则他们还要像朝鲜人一样在魔爪下生活多少年
天涯沦落客V : 回复@端午节的山峰:呸
刘怡岑___Corrine : 其实这两个家族私交还可以[笑cry]
Louis_Yii : 真到投票时候，谁知道呢
天涯沦落客V : 回复@西海一剑at动漫:信新闻联播就行
传达室电话 : 不管你愿不愿意世界都会照着他的规律运转，不尊重自然规律都将被忽视。
七月流--A : 川普民调再高，也没啥卵用，他过了选民这一关，过不了选举人这关
拓扑老夫子 : 恼羞成怒了
少林肆 : 感觉要是川普真选上了，美国政坛格局可能要重新洗牌了，两党的基本盘要重组了。。。
波纹涌动 : 有时候赶鸭子上架，也是一种报复！[偷笑]
端午节的山峰 : 老布什的好儿子小布什亲自屠杀了伊拉克人民。希拉里亲自导演了阿拉伯之春，祸乱中东北非人民。本属一个军伙贩子资本党，何谓叛党。美国大选本属作秀，川普当真，直言无忌。小心布什父子这对屠夫杀了你！
东方小村民 : 特朗普想输都难
18green : 喜闻乐见
夕陽武士_ : 老家伙这是为他小儿子杰布布什[衰]，被床破羞辱并击败，复仇[嘻嘻]。
东方小村民 : 与人民为敌
清晨的太阳668 : 叛徒布什家，你们家是伊拉克人民的死敌！[怒][怒][怒]
木立大风 : 美帝政党竟然不搞统一思想，要求服从组织领导，提倡大局观，美帝彻底没救了。
moonbox089 : 回复@Sylvainhuret:[疑问]
居越而思齐 : @Sylvainhuret 既然回复了就不要关闭评论，你自己去数数这些年布什家族与克林顿家族多少次了，这TM是胡编乱造么？
加洲刺史 : 万恶的资本帝国主义，远不如我宇宙真理公平和谐，哼！
艾克坚 : 这事说明，民主党和共和党，并不是什么多党，本来就是一样的，当共同的敌人出现时，随时随地可以联合起来。
西海一剑at动漫 : 老布什都来了。当年到美国，正赶上总统大选，正好是老布什输给克林顿的那一届。那之后俺就不信什么选举了。别人信不信是别人的事儿。往事如烟。
驍遙白駒 : 这难道不应该关注的是自由民主，叛党那只是某些国家政党的特色
Sylvainhuret : 回复@居越而思齐:能不能说点实际的，这些胡编乱造的话有意思么
居越而思齐 : 布什家族与克林顿家族轮流坐庄、独裁一体化，不太允许其他人染指，已经有了个奥巴马，怎么可能再支持川普~
topkings : 美国的所谓政党，本来就是松散的社会团体，没什么固定的党员登记和各级党组织。
白云蓝蓝天 : 其实民主党和共和党在川普出现之前，基本已经同化了，选举不过是个过场而已，选谁都一样...川普这个 另类一出现，就真相大白了
风是否吹过222 : 不是有川普，小小布什就有望成为下届总统候选人，布什家族有可能出现第三位总统，老布什要能支持川普才怪呢。[嘻嘻][嘻嘻][嘻嘻]
到处看看_818 : 政治交易吧
梅新育 : [微笑]好看大戏.
做梦的石头儿 : 民主党、共和党本就是总舵主开设的两个分堂口。
cantonliu : 叛党叛国?
四分卫SPA测试版 : 老布什叛党，会不会被批斗，被停止养老金，以示惩罚？
大南瓜种子 : 官官相护，或者说，大资本家肯定要抱团呗。
爱丁堡的梦想家 : 然而这一票并没有什么卵用
一言大义 : 这才是老成谋国
Starfighter : 身后都是一起的
