谭军维T-jwei : 两开车的都有病
董忠俊丿 : 白车的人真的贱啊
淮水长 : 应该禁驾，太危险了。
汉正能源 : 山东人在这方面比较突出，亲身经历过
蒙眼佐罗 : 法律管个屁
MMMessiah : 不终身禁驾还是管不住，可别就罚款扣分了事[doge][doge][doge][doge][doge][doge][doge][doge][doge][doge][doge][doge][doge][doge]
莫雪亦央 : 白车过分了 明显故意的
Athexy : 终生禁驾，留着也是社会的祸害[怒]
Nicetoli : 不要害人害己[拜拜]
啸行 : 这种人要离他远点，没准哪天雷劈到他时连累你
多年之后你在熬粥 : 不负责任 死不足惜
凌乱了凌乱了 : 左后轮？右后轮？扭来扭去干什么。其实速度不够快，顶对地方也不会怎么样。就是严重危险驾驶，这可是高速我的哥
老_关 : 干死白车!
___Invoker : gta日常
宁静高远自飞扬 : 高速公路版的“华山论剑”？？？[挖鼻][挖鼻][挖鼻]
Letdown_ : @李李李小点-
碧鳞青羽 : 涉嫌危险驾驶罪
老茶Joy : 这司机找到了应该严惩！万一出大型事故怎么办？真不负责任啊
longinnng : 厉害了，我的哥！
Lucky彡飞语 : 这种人直接抓进去，住个五到十年？
Lucky彡飞语 : 这种人直接抓进去，住个五到十年？
梦琦笔谈 : @艾薇巴蒂麻辣小龙虾
睡眠不足J先生 : 拍电影呢
陈魁Scar : 这不是危险驾驶罪吗，得判刑
瘦风皱水 : 拜托多关些年出来会害人的
蓝玉35718 : 这样好勇斗狠、意气用事，迟早得出事。赶快成熟点吧，别等出了事再用后半辈子来后悔
我有精神病杀人不偿命 : 黑车按道理处在有利位置，完全可以秒杀白车，飞行员最喜欢咬尾攻击
西凉主簿 : 秋名山因你更精彩
繁華三千看淡即為雲煙 : 说句难听这两人怎么不撞死呀
来来干了这碗翔 : 击毙
另一个庄里人 : 你开车的目的是什么？到达目的地，或者是享受驾驶乐趣，不要轻易被外界因素影响兴致。退一步真的会海阔天空。真的。
灰多姐 : 有时候争的就是一口气，那种自己开车慢吞吞还故意挡别人的人在家好好待着吧，别出来丢人现眼
年炳辰 : 这种情况两车直接吊销驾照。为了其他人的安全。然后另行调查原因，进行罚款
蔡一刀是我 : 上次去机场就遇上变态的，大货车故意别，完全不管人死活的，这样的人迟早出事。
ChallengerCJ : 卧槽这是在高速上啊！！查到吊销驾照！！玛德这要是在高速上看到这俩货在前面吓死个人了都
风树炫舞 : 真是不要命了
嗨六月10 : 像在看电影
一路上有你Gao : 开车是不能着急的，礼让彰显的是一个人的素养。
电磁方天戟 : 请终身吊销驾照
行走在土地上 : 害人害己，终身禁驾
清風9220 : 吊销驾照，终生不得申领驾照！
纠结的--暴力熊 : 回复@畅畅是个忧桑哒小胖纸:碰碰车[doge]
茗嘴猫猫 : 回复@Siren_KK:在高速上为什么要超车呢？
刘维维是只猫 : 这么恶劣，够得上终身禁驾吗？
丶凡帝罗的梦想 : 俩车赶紧死！！！没人拦着！死100回都不亏[怒][怒][怒][怒]
Fishing_林三 : 这个循环播放好坑人 我盯着看了好几分钟 我还说这个黑车到底有几个保险杠啊
叫老婆老公的老公 : 自己撞得都快成卡丁车了，人家屁事没有@高飞George: 我开长城皮卡很多年，还没见过这样的[哈哈]
C_杨鹏飞 : @鸡蛋的第二梦
畅畅是个忧桑哒小胖纸 : @纠结的--暴力熊
刘只只hadid : @马哥-马哥 这俩[老虎]逼[微笑]
-Sue-Sue : @彷徨的橙子_
草原百灵201209 : 这车开的真无语了
极速蜗牛0422 : 这是作死的节奏啊[怒][怒][怒][怒]
生活在永远 : 也不知道这个有没有完整的视频啊？后车速度没起来撞个屁啊，要不就忍着，要不就一下干死，扯来扯去的。现在杀手太多。今天就遇到一个，我们车绿灯直行，从南向北，我坐副驾，一个女的从东向西突然出现右转，从我发现那车，那个娘们都没往左面看一眼，到路口直接右转，我们车减速。
Summer_gorgor : 判个10年
手机用户3440678450 : 无可奈何，只好拼了！
田建远 : 无聊之“车”，无趣之人，呵呵！！
L1LJOY : @我是馨馨馨
徐亮子NEXT : 热评那个燕山大学那个真逗，没有学校补贴你就饿死了[微笑]？？？你整天宿舍躺着玩电脑当然会死
淮河边慢步 : 这两个孙子要是遇上 渣土车 肯定蔫
一个水瓶座boy : 回复@simple_life丶:共赴火葬场
你微笑双眸 : 说好的爱车如爱妻呢
叫我小美美眉听到没有 : 找死吧，高速上还敢这样
天然卷卷然天 : 白车喝多了
沧桑的脸伤不到很二的心 : 那个白车也是有病
erghynetu : 大货表示：来来来[笑cry][笑cry][笑cry]
erghynetu : 大货表示：来来来[笑cry][笑cry][笑cry]
对门老王家的小王 : 回复@手机用户12476586758:应该刑拘，危险驾驶罪！
核弹工厂英伟达 : 抓起来都枪毙了吧
屌丝的世界你不懂Salon : 大河向东流啊，谁上热评谁是狗啊，诶嘿诶嘿单身狗啊，永远没有女盆友啊～～
一五算一 : 安全文明出行，为自己和他人的生命负责
明哲要唱歌 : 回复@ada-schnauzer:是的，想法一毛一样
鼈髦彘年04508 : 一时脑热，不知道啥时候“死”！
小甘1100718835 : 终身不得考驾照
陈毅网说 : 这样的人不适合开车，下去找个位置打一架好吧？不要危害他人！
饿_死鬼 : silly B
Exxxthx : 脑子不好的人就不要开车了
猴馨猿 : @做鸭一万年
武汉环保 : 安全文明出行，对自己和他人的生命负责！
成华统建 : 安全第一！！！
枫与猫 : 回复@simple_life丶:银镯手上戴
ZT平安是福 : 冲动是魔鬼，事后会后悔。后悔没有用，法律要严惩！
淼訫訫訫 : 都是酒驾吧[嘻嘻]
清原在线online : 必须严惩。吊销驾照，追究刑事责任
歐陽璁-洋蔥xi : [失望]
山子野夫 : 回复@simple_life丶:出事终生误
Amelia的selection : 这些人终身禁驾都不为过！不过法律太落后，最多拘留几天！
种花家的酱油兔 : 青银高速。。。。。。
好脾气先生-M : 身边事儿[黑线]
大道至简-cc : 吊销驾照，终生禁驾。[弱][弱][弱]
别做哪些无谓的承诺没资本_984 : 这样玩很带劲吧[偷笑][偷笑][偷笑]你们爸妈知道吗
JFCHIU : 不要命不要车可以，别害人啊，马路又不是你家的，那么横行霸道
天佑野牧 : 这两辆车的人活着下了高速没有知道的吗
深巷酒业有限公司 : 哎哟，屌爆了~~~~~~~~~[鼓掌]
a-高手话不多 : 黑车气坏了
佘靖靖 : @坑b大怪兽
高飞George : 我开长城皮卡很多年，还没见过这样的[哈哈]
蓝色WETOR : 这两个没死吗？？
别做哪些无谓的承诺没资本_984 : 不过是两个存货[doge][doge][doge]
simple_life丶 : 斗气一时爽，下一句网友来接[思考]
Content_C : 碰上故意不让人超车的真的蛮郁闷的
蒙老七 : 两个都怒了啊！年轻气盛！不错～又可以多卖车
51lu13点com_我要撸一生 : 强烈抗议广告时间插播电视剧！【[ali扑倒]看黄電影的看我名字[心]】
堂唐谷主 : 判刑
我女神莫莫 : 天天飞车玩多了！！！！！
人生保险规划师 : 两个都终生禁驾！行政拘留15天！
xi_妤 : 开白车的是智障吗？这马路是他家开的？
一钩新月天如水 : 路上的王八蛋很多。建议在以行车记录仪为证据，重罚前车
去淘宝神翼数码科技 : 强烈建议，考驾照，把思想品德加进去。
水兵火星- : 智障，自己死就算了，要是殃及无辜怎么办，这种人不配活着
w网虫 : 开渣土车的那些年，没发生过斗气车
Lady_CaCa_ : …飞车戏看多了吧
Irene-润 : 真是没必要牺牲自己去教育别人 况且这俩司机都属于“别人”
张菇凉十三 : 脑残为什么能考驾照？？？
军军哥9527 : 社会太乱，不服就干
七仔GOUGOU : 高速公路上耍二，那是用性命玩游戏，这种二货比毒驾、酒驾更可恶
阿里芭芭 : [挖鼻]
_韦仙森 : @仇翕翕 这么美丽的地方，不打算开慢一点欣赏一下吗
朵朵邹 : 这是有钱人玩碰碰车，而且人家都是活够了的疯子
missliu偶 : 生命可贵啊！
甜甜爱琪琪洋 : 很气人，自己墨迹为啥不让人家过，也许人有急事
猫眯姐姐 : 对这些有钱人直接无语
女王大人柯柯柯柯6888_334 : 其实俩人也就是斗斗气，警察叔叔你也别太但回事，抓住了这两人，简单的判个死刑也就算了！
PFStress : 想想我要去修车……斗气车都不知道保险赔不赔～算了，忍着多吃几口饭多骂几句粗口[doge][doge]
乱唱的帆 : @poordoggy 你看你这种路怒症患者
乌里雅斯太百灵鸟 : 年轻人没办法
我是一枚大直男- : 白车子的司机真他妈的欠扇巴掌，我脾气也没这么好，肯定会发火的 脑残
即墨法院 : 【高速公路两车斗气现“自杀式撞击” 警方已介入调查】
张新Zxin : 是气人
我所幻想的未来- : 遇到这样的真特么恨自己当时开的不是坦克
V鄧國V : 回复@ada-schnauzer:所以你还不是去不了秋名山
Ohcaptain_Mycaptain_ : 死亡飞车啊我擦！
心蕊hh : @杨英汉
面面面面包砸 : 望严惩！希望这俩司机以后都不要再开车了，不要别人的命也不要自己的，根本就是个疯子，应该好好治疗。[微笑]
执手青春2016 : 真是有钱烧的慌[拜拜][拜拜][拜拜]
Peter_旻奇 : 这种傻叉吊销了至少三年不许重考吧
bilibili美少女biubiubiu : 看到淄博戳进来。。。
Xc弓长衝 : 俩信球
最爱蔡旻佑 : 回复@Alex-__-xelA:顶
我一猫九命 : 富得太快，人的素质还没跟上来？如何使是好[思考][思考][思考]
LBYgz : 严重是挺严重的，不过也没到“自杀式”吧..？[笑cry]
一颗豆子三无 : [汗]少斗气命就一条
黄振毅同學 : 兄弟，互相伤害吧！[哈哈]
AmandaLouLOL : 淡定淡定点儿，也是跟我自己说的。
股市百科 : 不如都把车停服务区，找个没人的地方痛痛快快解决下～
Hi豆宝贝 : 太自私了，不考虑别人
D調暧昧2011 : 光看视频觉得白车垃圾，好好的干嘛不让人超车？[怒][怒][怒][怒][怒][怒][怒][怒]
酸溜-溜 : 都没死过
Lucas_梦 : 吊得不得了
喝茶喝好茶 : 可怕可怕
sunnyqueen8 : 看看中国人的素质吧 就知道窝里斗
灌口茶卜道 : 何苦呢
Phoenixville : 这可以判刑了吧？！
伟伟这小子 : 国家对交通肇事的处罚太轻了，死刑用上来你看会不会有这种状况出现
bzy4463 : 危害公共安全，坚决严惩不贷。
彳血劍 : 开起亚的[哈哈]
人本后山 : 危害公共安全是犯罪
对不起我係警察 : [bed巴掌][bed巴掌][bed巴掌]兄弟你该转行去当特技演员了。
晕船的海盗陶 : 没车没烦恼
无限极达人姜梾 : [笑cry][笑cry]
薛定諤的笨貓 : 有毛病
秦人一炬 : 喜欢搞事情
文岚_扇子 : 回复@喏奥利奥华夫:有些人交规不知道看没看过，你打个闪他就跟打了鸡血一样以为你挑衅他。
江南火红 : 拍电影吗？
bearpuppy : 回复@陳陳陈元培:尤其是穷[doge]
笨蜗牛321 : 天朝二逼真多
哎呀你好5890985170 : 视生命如粪土啊！卧槽
逆风飞扬ter : 这是对其他行驶在高速上的人的生命不负责任！拿别人生命光儿戏！判无期徒刑！
12墨滴26 : 梁山年底总结菜园部张青说：今年都说有农残菜卖不了亏本了，所以今年的分子钱不能缴了。餐饮部孙二娘说：现在狠刹吃喝风，也亏本，山寨的份子钱也交不上。渔业部阮小二道：现在水污染严重，鱼都死了，也亏本。鲁智深跟着嚷嚷：我们部也亏本了。宋江实在怒不可遏骂道：你他码的拦路抢劫的也能亏本?。
展晴雨yy : 艾玛，害人害己啊，一出车祸，后面的车也很危险的。
Alex-__-xelA : 河北省燕山大学拖欠学生补助三个多月不发，学生都快饿死了，学费却收的比谁都快@央视新闻
宁琛琛微博 : 命不是自己的 真是 有多少人想活着都难 抓到了使劲蹲局子 交罚款
库蜜木也要投三分 : 最怕这种想死祸害别人的
手机用户12476586758 : 这种得吊销驾照吧？他要是还能上路就是对别的无辜的人的不负责任
翁源仙鶴 : 不要伤及无辜就好[doge]
ada-schnauzer : 有时候是真生气....不过关键时刻我就合计心疼我车....就算了
