洗奶娃哇 : 我觉得KIMI都已经走了 有些人为什么还要给他都套个不干不净的名头.有些人不惋惜也请别当笑话看.
用户5506885511 : 一个人的时候 照顾好自己，如果有下辈子记得不要离我们太远  我们怕碰不到你
静静的兔宝宝 : 希望多给明星艺人们一些空间和宽容，他们只是跟我们从事不同的职业而已，不要给那么多的压力，希望人与人之间多些理解和鼓励。
关于1个monkey的故事 : 今傍晚 我这里的天空是粉色的！！！！昨天也是！！！[傻眼][傻眼]惊呆了！！好神奇！！！厉害了[傻眼][傻眼][傻眼][傻眼][傻眼][傻眼][傻眼]
海依_ : [蜡烛] 
小珊子子子子 : 回复@易千分之二八:是呀是呀以前一直就是路人，没追过，但也绝对绝对没有说过他一句，现在看到都忍不住哭了，真的很心疼，真心心疼他的笑
小豆芽Lu : 不会再见
Waiting曹 : 还是不想相信你走了
天早灰蓝z : 一路走好
半吊子不懂 : 适当的放手，是彼此的解脱
sinryeo : 天使的翅膀是粉红色的
静情娱乐 : 希望你们尊重死者，一个活泼开朗的阳光男孩逼成了抑郁症，又被逼死了，还要怎么样[怒][怒][怒][怒]
爱谦就是薛之谦 : 你一直是我们爱的KIMIM
慌慌张张不停歇 : 我们错了，真错了，不知道你这么痛
singsing的马甲 : 你能不能回来
乖乖and小婕 : 真心看一次哭一次，爱笑的男孩哈，这早上还躺那呢，这会已经火化成灰，你就当真在这世上消失了[悲伤][蜡烛]好男儿一路好走哈，记得我们爱你[泪]
彭家小闺女 : 好想再看一眼他，晚安乔[哈欠]上帝一定会将你保护好的因为你是那么阳光善良
许的闲话 : 唉！一个人小年轻人这样走了，就让他静静的走吧。真的逝者需要你们这样热热闹闹吗？
TOP我男神11 : 回复@壹介伙夫:[难过] [难过] [难过] 我不相信他会自杀
M_Melodya : 好可惜  难过  Kimi愿你在天堂没有孤独和失望！
KimHyun__A : 一路走好 哭了
camelcross : 虽然不是粉丝，看到新闻还是忍不住落泪了。那么年轻就去世了，太可惜了。希望他的父母能快乐起来，希望他安息。
门前有只猫MAO : 唉[蜡烛][蜡烛]
RM0922 : 我想知道棺材里真的有人吗？
TY包包儿 : 到现在都有点不敢相信 没有任何预兆的 太突然 感觉在开玩笑一样 好难过
转眼你于天堂此后万物黯淡 : 秋分，跟你说再见……善良的孩子，记得跟着光走，去天堂[向日葵][向日葵][向日葵]
空气猫的太阳 : [蜡烛][蜡烛][蜡烛]心疼
老鹰室老鹰 : 好了不要给我看这个了我都要忍不住了[悲伤]
嘘鲸厌 : 一路走好[蜡烛][蜡烛]
小小夏子ccx : 回复@全微博最丑博主:但愿你是去了的《W两个世界》
沐沐美食 : 不管你离不离开，我依然爱你
沐沐美食 : 不管你离不离开，我依然爱你
elena要努力 : [蜡烛][蜡烛][蜡烛]
秋水殇情 : Kimi，一路走好！愿你在天堂幸福！[泪][泪][泪]
許SU婷 : 走好啊！永远爱你、乔
蒋雨童Rosalind : 回复@木子eng:说得像其他国家的明星去世了 不会轰动一样 世界都是这样 有什么好奇怪的 我看你这个人才奇怪 难道不属于这个世界吗？难道痛惜一下才28岁的有才华的他去世的资格都没有了吗
chen-菲 : kimi一路好走[蜡烛][蜡烛][蜡烛][祈祷][祈祷][祈祷]
Drug女人 : 愿逝者安息！[蜡烛][蜡烛][蜡烛]
敖Lalin : 一路走好。
尘迹V : 不真实，不相信，这么年轻
April是小水母 :  [小地主] 
竹林花海 : 眼泪流到脑袋晕晕的还是止不住，06年好男儿舞台上作为07年优秀代表亮相的你，这画面这么清晰，要怎么忘了？你匆匆一走，我们就得几十年后再见，好吧，只要你开心，找不到你也没关系，至少你不是明星，还好好的…[蜡烛]
鸢尾花开L : 一路走好[祈祷][祈祷][祈祷]
木子eng : 一天去世的人多了，农民工去世，劳累过度，农民去世，农药副作用。访民莫名其妙的失踪，各种离奇的大学生失踪，各种小贩被城管压迫，学生上学变相收费，学校和房地产挂钩，这些为什么没有人关注，总结了下，官媒，当官的媒体，总是把舆论引到另外一边，醒醒吧，中国人。
but只有但是 : 还记得之前的  锦绣缘华丽冒险  一路走好
Crystal-毒藥 : 你走的那天我根本没睡着 今天早上也早早的醒了还是不愿相信你已经去了粉红世界 今天刷一次微博哭一次 明明不是你的死忠粉 却为你心疼 这个世界没有温柔的对待你 愿你来生做一个平凡的大男孩 快乐的活着
刘诗丹小朋友 : [蜡烛][蜡烛][蜡烛]
刘诗丹小朋友 : [蜡烛][蜡烛][蜡烛]
小路媳妇l : 虽然不是他的粉  但是作为追星族真的能体会那种痛＇   每次看到这个消息  眼泪都会不由自主的掉下来
梁将成 : 下辈子，别做艺人。
安释然 : 天堂没有抑郁，一路走好。[蜡烛]
陌路新痛 : 爱你。一直。却终究负了你
爱旅行的指尖 : Kimi一路走好，我会永远记住你的[心][心][心][心][心][心][心][心][心][心][心][心][心]
上善若水ss11 : 不敢再看关于你的消息了，越看越难过越想要哭，整天想的都是你灿烂的微笑
怀珠0520 : 如果全世界都对你恶语相向，我就对你说上一世情话
美美de星儿 : 我好遗憾没去现场 我以为不给进[泪][泪][泪]
英雄漂泊在OZ : 如果可以，真希望你当时没有走上这条演艺之路 哪怕只做一个普通人也好[蜡烛]
聆听a未来XTO_924 : Kimi一路走好[悲伤][悲伤]
阿晴的 : 愿善良的人，都被温柔对待！好好的！不要在痛苦！
潘帅帅的雅秀 : 回复@哈宝哈比:是啊，明星也很累很无奈的
温蒂噜噜啦 : 什么都不想说[祈祷][祈祷][祈祷][祈祷]
时光经过岁月 : 一路走好[蜡烛]
潘帅帅的雅秀 : 回复@哈宝哈比:对的
Ppanrh_ : 一路走好[蜡烛][蜡烛][蜡烛]  乔恩会好好的  [悲伤]不要担心[悲伤]
悦阳妈妈 : 希望这个社会好好反思反思！这样一个青春年华的明星为什么会离开世界？这样的代价太惨痛了！
王倾羽 : kimi一路走好[蜡烛][蜡烛][蜡烛]
Sunny女神经 : 沈居安，我爱你，那是最后一次在电影院看见你了，愿天堂再无悲伤，永远会记住一个28岁的大男孩，在为自己的生命闯荡挣扎，我见过这个世界上最干净最美的笑是你给的，我想以后再也不会有了。。。
Abby_希 : 虽然不是粉丝，但是通过节目喜欢你的阳光般的笑容，看到你去世的消息很难过，很惋惜，希望你一路走好。。
苗儿sen : 愿你在粉红色的天堂幸福快乐 一路走好 [蜡烛]
天生无泪我本无心 : 回复@唯一的SUPERJUNIOR:慢慢回 别急
云起-妖精是只猫 : 我还记得网传你去世的时候多少粉丝在下面评论，希望你出来澄清，然而这一切却是真的，直到现在我还不愿意去相信你已经离开了我们[伤心]
唯一的SUPERJUNIOR : 回复@天生无泪我本无心:瞎说
Ppanrh_ : 心疼[悲伤]
L李萌- : 陌生的你  熟悉的城 只为寻找快乐 错过了属于自己的生活[心碎]
我是杨晓娴 : 说好了要微笑着送你离开的，可是眼泪它还是不听话的跑出来了[悲伤]kimi，一别便是永离了[伤心]你能感受大家内心的不舍了吗？从此粉色的天堂里有了一位爱唱歌的天使[天使]
萨尔尼诺 : [祈祷]🏻一路走好
庚默默 : 哎，就这样走了，到现在都不能接受！
蟹蟹蟹蟹老板儿 : 虽然不是粉丝， 但是看到消息很心疼，直到现在都不敢相信是真的！希望在另一个世界没有恶语相向，开开心心做自己！[爱心]️
开心的dinosaur :  [nono心心眼] 
freedomthule : 真的好难过，想想就眼睛酸酸的，不仅因为他这么优秀，哪怕就算是个普通正当年的男孩子也不能这样残忍的对他。
呆萌小帅哥12378 : 乔任梁一路走好[蜡烛]
天生无泪我本无心 : 回复@唯一的SUPERJUNIOR:哎 心里没我[泪][泪][泪][泪]
我有毒呀s : [悲伤]kimi 永远爱你
粪粪嘿__ : [蜡烛][蜡烛][蜡烛]
mdzsml : rest in peace
小杨同志AA : 始终想不通，究竟心里是有多阴暗，才会骂的这么难听，人都不在了，难道还不够，？？
NoshIt_ : kimi一路走好   你还是那个粉红的男孩  对 你只是换了个可以让你快乐的地方继续生活而已  保重 永别[蜡烛][蜡烛][蜡烛][蜡烛][蜡烛]
温暖的小南宫 : 难受
乔戈1015 : 谢谢你，再见[蜡烛]，愿你在那个地方生活的快乐幸福，继续追求你的音乐梦想，我们爱你！！！
爱吃刀鱼的汪 : 再见。念安
氾尧 : kimi一路走好
minoz芬_9月6飞Korea代购 : 一路走好_
流浪人你若在心里 : 愿天堂再无痛苦，愿天堂有你想要的所有样子[祈祷][祈祷][祈祷]
阿闵阿闵我是佳佳 : @蓝海下的一颗星-YOYO
Eve-MIn- : 很多人说不是粉，但都不肯相信乔的离去，我也是伪粉丝，在相爱吧看到乔徐那对，就很喜欢他们也喜欢乔这样开朗大笑乐观带给我们欢乐的男孩，或许这就是大家不能接受，看起来那么快乐的乔居然以这样的形式离开大家，不愿相信笑得如此灿烂的却自己那么不开心，好心疼，乔那灿烂的笑容定格在我们每个人心中
天生无泪我本无心 : 回复@唯一的SUPERJUNIOR:哈哈哈哈 回的真快[笑cry]
帕克尼亞 : 上帝保佑你， 願你在天堂能安息。 希望你不要有太多挂念， 與你同在。
Fiona_薇vv : [祈祷][祈祷][祈祷]
唯一的SUPERJUNIOR : 回复@天生无泪我本无心:别哭了
猫的树yuan : 走好
梨靥涡 :  [bofu扭] 
Li黎黎是个大宅女 : 我不敢去相信
O紫色依恋O : [蜡烛][蜡烛][蜡烛]
孙玉熙小公主 : 什么网络暴力，都是他经纪公司的问题
张美丽的米粒 : 喜欢你，始于颜值，陷于才华，忠于人品。
娇娇俞 : 不道别，就还在。
丁当_Della : 福原爱结婚啦[爱你][爱你][爱你]
我的努力配上我所有的幸运 : 假如，我们每个人的生命都给你10天其实，你可以活好久，娶妻生子，一直到老，这么久，觉得你只是和我们开个一个玩笑，虽然不是你的粉丝，可是还是很难过，你真的太暖了，太年轻了，来生一定要用自己喜欢的方式生活，过20几年，我们老了，你还年轻，到时候还想看你暖暖的笑容！那边，应该有粉色的天空吧
ovovove : 另一种方式活着 kimi 
yczs虫虫 : 一直不相信这是真的[泪][泪]
张美丽的米粒 : 你是我第一个真实见过的明星，也是我最最喜欢的男生类型，这么多天了，还是感觉无法接受你的离开，这几天一直好压抑，不停的刷微博就想找出你其实没死的痕迹，因为我真的不能接受。可是越刷越难过，越刷越想不通，为什么是你，为什么偏偏是你，这样一个美好善良的阳光少年。
没有理想的傻子不是好学渣 : 回复@火龙果的麻麻Mua:无论怎么惋惜，他都回不来了……
梦魇-Megni梅格妮 : 这个世界会记住你永远的你 那个爱粉色笑容永远很灿烂阳光的你 JGD[祈祷]
婧逗比 : 一路走好[蜡烛][蜡烛]
你来花就开1997 : 突然好想成为一名心理医生，可以穿越成为你最要的人然后尽自己最大的努力去拯救你。
南城雨冷_ : 你说为什么好好的一个大活人忽然就这么不在了呢[伤心]
c叮当猫传说中的蓝胖子 : 渣浪，请删除图片，现场工作人员爆出的图片吧？后援对们走法律程序吧
一个老是鼻塞的啼啼 : 不知道该说什么[泪][蜡烛]
没有理想的傻子不是好学渣 : 倾城四少，再相聚，竟是他的追思会。
Bothannd : [蜡烛]
滢滢一水间 : 一路走好，总感觉你走了好久了，心里好难受
草二君 : 你一直都是我喜欢的那个粉红控的大男生[心][蜡烛]
Brittany_桐 : 永远记得你的微笑[悲伤][蜡烛]
梦魇-Megni梅格妮 : 有一种情谊叫安以轩与安钧璨、陈乔恩与乔任梁。 JGD[爱心]️ 陈乔恩失去了两个最爱的好友也最懂她 小乔是最让他失控最伤心的 看着她都特别心疼 小乔会希望看到你以后跟他一样的笑容想念他的粉红。
booany : 回复@beonmy:我也会相信他一直都在
没有理想的傻子不是好学渣 : 希望他的天堂是粉红色的
撑把伞淋雨 : 一路走好 莫牵挂
娱乐Ximusic : [蜡烛][蜡烛][蜡烛][蜡烛][蜡烛][蜡烛][蜡烛][蜡烛]
SFC_澳洲玖曉零在SH : 聽說今天他很安詳很帥 就像一個睡著了的王子。聽說很晚了還有粉絲不願離去 想陪他久一點再久一點，今天的一別真的就成了永遠。想象著他是被冰封的王子，有一天會醒來。總是不忍心去看他笑起來讓世界都變得溫暖的照片，不是他的粉絲卻哭紅了眼，一個粉絲對偶像不求回報的愛我懂！ 愿他安好[蠟燭][蠟燭]
CabinZhao : 回复@一生遥不可及的浪漫:本来就是，不要转移话题，他要是丑你肯定也不会关注他，你这样地妹纸也就是视觉动物…他和你非亲非故，甚至都没有和你说过一句话，除了外表能吸引你，还有什么？肤浅的女人…
小曾子热爱生活 :  [挤火车] 
