沙漠老胡扬 : 什么情况，我想知道。
JiiinG_G : 警察[列车员]🏻叔叔是为了你生命安全着想 一定要守法 这是你自己的命呀
流浪的人-尚由 : 转发微博
Miss百步笑五十 : 假酒害人？
贾大肚 : @yesyesyesssss-  联系联系 卖她tr
小米是包子 : 脑子是个好东西
梦回流年42591 : 丑的都打了马赛克了，还TM萌。[doge]
瘾思忆 : 其实我觉得这样挺可爱的[doge]没大哭大闹要上吊 多美好的[doge]
星星星pigeon : 恭喜你，中奖了[鼓掌][鼓掌][鼓掌]
喵啊喵MIAO呜 : 哈哈哈哈哈
以前的放羊娃 : 这女的本来就长的漂亮
瘾思忆 : 哈哈哈哈哈哈有点想笑
浮云fuun- : 回复@恆昼:也可能是亲爹…
wsdgml : 总比那些撒泼的女人要强
LilChang- : 回复@小鹿曈子:[给力]
谢嘉豪_Uncle : Q7
小白兔的情人 : [笑cry][笑cry][笑cry]
蓝小喵flynn : @生命向我们的召唤永不停息 [哈哈]
孤屿Roy丶 : 666666666
AsDapuvhRNN : 回复@搞笑靓妹妹:不觉得啊 有些我只是说有些开玩笑说来搞笑的啊
R吾日三省吾身 : 不能用，用了就是两个人了
like看破红尘 : 还配合你演出的我演视而不见
啸宇-同学 : 哈哈哈哈她还剪刀手@管延杰-
策马奔腾的奶糖 : @焦虑大飞哥 @UnlceLazy @说好的大排呢
东风雪铁龙客户服务中心 : 我也是醉了
WKezzHi : 自以为荣，不知羞耻！
独孤木有剑 : 美颜相机:这是我做过的最大牌的广告[挖鼻]
独孤木有剑 : 美颜相机:这是我做过的最大牌的广告[挖鼻]
我不想拆穿-你 : 真醉了
碳酸钠纯的 : 丢死人了
王璟琦这个名字被占用了 : 最后严肃批评教育，和阿富汗交通大队大队长自罚三杯么[doge][doge][doge]
沐夏的风mz : 有病，得治
小鹿曈子 : 回复@LilChang-:是我
江锋同志 : 把交警的家伙都逗硬了。
木子姐姐L : 这个故事告诉我们，喝车不开酒，开酒不喝车[good]
Hello漂浮魔少女 : 现在我们的羞耻心越来越棒棒哒呀，呵呵
可爱的赵赵酱看不起垃圾的杜废废 : @24号我的信仰
可爱的赵赵酱看不起垃圾的杜废废 : @24号我的信仰
莹莹小蝎子 : 脑残年年有今年特别多
沈先森就是我 : 还是乌鲁木齐的，
I古月先先貝I : 希望交警是给她用的美颜相机，了却她入狱前的最后心愿
Paradoxesss : 怎么办 有点可爱
注册会计师张浩 : 回复@余蛟16740:新疆第一啤酒。
那我就叫费劲吧 : 醒了就晓得了
K城市雕民K : 中国的美颜在世界整容术中占据了举足轻重的地位
智障的阿俊 : 配合的美颜了一下
毁灭兔 : 智障
婉余an : 等她醒了之后[笑cry][笑cry]
单亻徐只是单人余 : 回复@快手陈:现在好多了
琳_赵 : 醉驾是对生命的不负责！无好感。
开心的一塌糊涂 : 回复@成小韶念去去:二货
-阿星酱- : @谷小豆豆豆豆豆 @谷小豆豆豆豆 [噢耶]你看你看～～～
TIAN_TyiAN : @喜欢吃鱼吗TuT 叼不叼
地球村熊孩子 : 富家小女孩
日床小能手 : 这是个广告
SherlockRojers : 不是很懂你们年轻人
有嘉折首 : 回复@冰鎮金魚燒鮨:醉酒驾驶还算没有闹事？
---Mgy : 多大点事？厦门台风时候不见你发，厦门人顶起
辕少快取我屠龙宝刀来 : 牛
金枕棉 : 第一张笑得好开心，虽然是酒驾，当严肃处理，但感觉这姑娘挺可爱的[哈哈][哈哈][哈哈]
金色飞哥 : 蠢货，还要摆拍，过80你也够厉害的[赞]@人民日报 @中国新闻网 @中国之声 
我要继续上岸 : 开q7,,,也就不在乎了吧
CrimsonPhoenix : 哈哈哈可以可以，可以关起来了，谢谢
SamClaflin孩子都生了 : 奥迪
汤寅生 : 回复@Liiye_:没呢！我就是回答了1+1=2的问题
汤寅生 : 回复@Liiye_:没呢！我就是回答了1+1=2的问题
2011gengda : 你咋不脱光了拍呢
金阳枫叶红 : 长得丑，只能这样了
土豆香蕉喔 : 不管怎么样酒驾都是在拿别人的生命开玩笑!!
薄酒阿 : 哈哈哈哈想知道这姑娘微博
我超级讨厌吃鱼 : 没想到我昌吉第一次上头条还是这种事。。
石海VIP : [哈哈][哈哈]喝酒之前我是新疆的，喝酒之后新疆是我的
l-whoyou : 有病
欢chong : 都醉得没仪态哪还有美貌在啊
BEBETTER-CREASY : 有钱人还是会玩
遗忘的鸟托邦 : 主要看脸，评论区风格都不一样了
梦很快乐- : 美颜，难道真的不能满足爸妈给你的相貌吗？那你可以内在美啊！
袁紫伊- : 丑人多作怪
成小韶念去去 : @开心的一塌糊涂
用户5608587097 : 妈的，召集全国交通死亡魂灵围观她，再让她看看酒驾死者家属现在过的啥日子。哼，跟玩似的，很多肇事者事后拿钱了事，1条人命就几十万，没事。
快手陈 : 2005年在新疆待了一年，发现酒驾很严重，不知道现在有没有改善[汗]
爱上你的小情歌 : 估计喝断片了
GEM-吳泽呅 : @阿阿阿-阿高浩伟 @hai钟海 @WLB忘不了 [doge]
柚西门 : 回复@鸵鸟_不会飞:酒驾看的是驾驶证 不是车牌 和车无关和车牌更无关了
好食材2016 : 真是没救了
BRIAN_zjl : 回复@我就是小熊啊:我的哥厉害了，禽兽啊，请带上我
泡-墨 : 醉驾我只服你[笑cry]
dx-多余的夕阳 : 条件反射[笑cry]
LEE早晨 : 醉酒驾驶要坐多久？
Jeremy_SHENY : 呀 又是个低能
小猴子的仙桃 : 难道可爱酒驾就能飞起来不撞人吗？
wilford2008 : 在中国有钱真好！
周周周周___ : 回复@是孙天琦啊:哈哈哈哈哈是我，我得把自拍神器拿出来
鸵鸟_不会飞 : 这是新A牌照，乌鲁木齐的车，和昌吉人民无关[怒][怒][怒]
阿诺-施瓦辛硕 : @硕硕的颜颜
六月喵小姐 : 确实是醉了
林比坚尼 : 智障
我就是小熊啊 : 我只想跟她酒后乱性[害羞]
年轻就要尽情疯狂 : 一看就是有钱的主，怕什么....
勤奋的辉哥就是灰太狼 : 不要脸有多可怕
smallrock : 看这图片……交警是满足她了？
Kiki就是我啊 : 哈哈哈@袜子杀手小PP
桑菲尔德的梦 : @猪头不回头 昌吉的！
那个求别打脸 : 警察[列车员] 叔叔的美颜就是厉害，五官都给美图没了
恒者唯胜yeh : 智障
-哎呦喂是你呀 : 回复@无公害KY:我们那好像没有代驾[眼泪]
柳园下的约定 : 新疆昌吉？？？？人民日报？？？？
Miranda_u : 新疆还好。一路畅通,马路上还没啥人.
LilChang- : @小鹿曈子 是你吗
Liiye_ : 回复@汤寅生:[doge]莫名其妙被撩了
Sally小花妹妹 : 又是奥迪[微笑]
IAmLittleLittle : 就只有我一个人觉得她是小三吗
IMCHAW : 心态挺好的[哈哈]
林夕9091 : @丢丢额丢丢
MiNi彪 : 看来是真醉了
只嘉 : 很毒
梦A380 : 第一眼看到的是她旁边的车，这女子不简单啊
ARoNg198509 : 奇葩年年有今年特别多[嘻嘻]
李明洋_____ : 可以开飞机了
美智阿 : 没毛病
啊啊啊扑 : 虽然很可爱，但是还是讨厌酒驾害人害己
二十一_y : 实力作死
闪电or坚果墙 : 拍得再漂亮也是要整容的命
zarafa_piupiu : 绝了我的姐，下次别这样上头条好吗[哼]
李秀佛 : 呀？還賣萌呢啊[笑cry]
髙然然 : 哈哈，一朵大奇葩
DK_夏天来了 : 抽血？
k-ris : 这人，不知道怎么说了[汗][汗][汗]
Chole冰冰 : 智障！
CYJ_CRYSTALCLEAR : 这是真的喝大了[doge]
ShamanAL8 : 啥鸟都有！啥仁都有～@小凯muller
小微薄放大镜 : 关7天，好好治治
打不倒的小怪兽_囡 : 醉了
国寿陈志阳 : 呵呵
撒啦嘿哟Jason : @懒熊君呀 [眼泪]
七磅_磅 : 第一眼就看到了昌吉[得意地笑]@大家cool
LIin瑞蓑梭 : 我的哥，12分没了呢，科一等你哟[doge]
6254889032461015塔塔酱 : 让我想到了破产姐妹[笑cry][笑cry][笑cry]
木乃伊Li : @Taciturn陶 咋和你一样逗[笑cry]
弓长程 : 为什么我觉得很萌
我是你泽哥- : 这不是卖萌...这是真醉了吧..
阳妞与龙少的爸爸 : 裤裆有味
M-雲龍 : @77认真学画画
致命一棍 : 没拉着交警合影就不错了[拜拜]
梦想是一道光 : 吊销驾驶执照，罚款两千元并拘留两个月，看守所待两个月啊，吃的什么干的什么你进去就知道后悔了
崔崔崔崔崔大个儿 : 确定这不是广告
wuli丝瓜 : 可以开车，但别在路上啊
东北大江_18496 : 牛果然是B 出来的
老司机CHenZQ : 酒驾谁都救不了啊
吃太多会睡不着 : 回复@拿一份爱给自己:就是感觉奇葩的人太多[微笑]
______九 : @妖妖小精
zaitu_u : excuse me？还有人跟喝醉的人谈脸皮厚薄、羞耻心、耍贱？你喝醉的时候也是大家闺秀大绅士的样子呗？你喝醉的时候也是清醒的呗？？虽然醉驾不对，毕竟人家没刷酒疯好么 🙄 至于么？？？能不能别那么刻薄？？？
zaitu_u : excuse me？还有人跟喝醉的人谈脸皮厚薄、羞耻心、耍贱？你喝醉的时候也是大家闺秀大绅士的样子呗？你喝醉的时候也是清醒的呗？？虽然醉驾不对，毕竟人家没刷酒疯好么 🙄 至于么？？？能不能别那么刻薄？？？
HD风扬沙 : 即使喝醉了也不忘爱美[doge]
寒风中争做可人儿 : 还有人觉得萌？酒驾不是犯罪吗？我天，我是无法理解马路上的潜在杀手萌在哪。去看看禁止酒驾的公益广告吧，犯罪之所以是犯罪，是有原因的。
青梦碎月 : 无可厚非 只是处罚力度应该加大 醉驾也应该吊销驾照[微笑]
lilicoer : 社会好疯狂啊哈哈哈
Darcy_达西先生 : 人生苦短，及时性感—美颜相机
Biubiu_jacky : 第一:酒驾开车的确不对。第二：全国每天那么多的酒驾被抓，怎么偏偏拿人家上头条？第三:喝醉了才会这样的，好吧[笑cry][笑cry][笑cry]黑别人的，你先问问自己醉酒之后的怂样[挖鼻][挖鼻][挖鼻]
青草爱吃糖 : 回复@克鲁鲁西:哈哈哈哈哈
许Zhixian : 美颜相机打了个好广告
人生一场不妨大笑开怀 : 中国马赛克打的多余，人家想露脸
寒露凝 : 喷她是因为酒驾犯了错，还心态好到觉得无所谓卖萌微笑摆pose吧？错了就应羞愧，不能因为没出事故就觉得没关系了
阿晟觉得工资太低 : @艾酱酱酱酱酱-3-
凤凰村黑皮 : 家中一条边境牧羊犬于9月19号早6点左右在上海黄浦区北京东路355号楼丢失，名叫巴顿四岁雄性对人极其友好，它通体只有黑白二色和大熊猫一样，最明显特征双耳尖尖上有对称白色，提供线速者重金酬谢，恳请 @警民直通车-上海 帮忙查看路口监控，从此一定爱党爱国爱警察，不在牢骚满腹说怪话。
Even沉睡 : @妖妖小精
鄭仲婕 : 回复@鄭仲婕:醉驾不好  好在没有造成伤害    应该嘴上积德
小雨是p粉 : 回复@野生评述员:行为不对呀，哥们儿，她是酒驾呀，万一撞个人，或者自己撞桥墩儿上怎么办。难道卖个萌就能把错误掩盖了吗？
白面小七 : 评论还有说萌的，说什么又没闹事有什么好喷的，我去，这都尼玛什么三观，醉酒驾驶啊，敢情得让她撞死几个以后你们才能认识到事态的严重是不是？多少人命幸福家庭都毁在醉驾上面了，你们还没事儿人似的，就该让这群醉驾的都死干净，她不顾别人的生命，别人就也应该拿她命当儿戏
王文杰joe : 美颜相机的广告
一本正经的胡说_ : 长这样子，再用美颜相机能美到什么地步。
妹儿别怕哥是好人 : 要是是个中年大妈，估计评论又是另外一个风格了
妹儿别怕哥是好人 : 要是是个中年大妈，估计评论又是另外一个风格了
ES李美丽 : 没祸害到别人就算好的了！哎
MonKey云 : 这个逼装的我给满分！
拿一份爱给自己 : 回复@吃太多会睡不着:看这样，可能是q7,有人的，这点小事不算事
落雪尘华 : 真是喝多了。。。[笑cry]
追求无望的梦才最光荣 : @凡夫俗子苦乐多 [doge]
桑德兰咆哮_ : 感觉自己萌萌哒[笑cry]
我是cshigh : 这是醉驾，比酒驾还严重！
媞子酱 : 好可爱啊 但是下次别酒驾了
卡拉牧羊人 : 这都能洗地[笑cry][笑cry]
晚枫先生- : 这世间呐，最怕的就是认真。[思考][思考][思考][思考][思考]
咸鱼菲otato : 回复@那一对飞过沧海桑田的蝴蝶:所以呢？老娘又不会做，会做也不给你做
熊鑫鑫JZ_Boy : 快10年以前了  我上海市长宁区长顺路农工商超市对面吃过上海式老葱油饼 当时是1块钱一个葱油饼，这味道 时隔10年 我还记得
大漂亮喜欢小漂亮 : 看到后背好心酸[悲伤]
我的排骨呢_ : 回复@爱哭的我却是孤独的她:锅盔是贴在炉子里面烤出来的
我尝着你话里面的奶油溜啊溜_ : @黄磊微博
RayrayThree : 老师傅背也驼了[悲伤]
唐乐了 : 其实很多正宗的传统风味都被那些仿的  伪的  冒牌的给覆盖了 其实这也是一种艺术，手艺！赞～
沐酱_Ashley : 中国啥都不缺，就缺工匠精神！
俞力为狩猎 : @大宁小nikee
你的昵称已被占用O_o : 葱油饼真的超好吃[馋嘴]
哥哥-aihily : 天凉了，可以排队试一试了[doge]
鹑火1995 : 匠人精神[强]
a小明明明 : 累的背已经这么弯了，哎
李东东Bugatti : 回复@四川气象:能做博导了！
渐行渐远CHEN : 我看过这纪录片[耶]
王小贝大叔 : 在上海经常会有葱油饼的摊子有人在排队
Shookie舒淇 : @Queena-阿七
Maxine_Lu : @门牙吧
春风再美 : 一生只做一件事也很好
春风再美 : 一生只做一件事也很好
大少爷的同桌 : 我想吃个热乎乎的葱油饼。
是我风华绝代万人惊艳的石榴姐 : @撕小天StaNet 想吃想吃想吃
麋鹿孑孓_YtWEi : 老手艺
就是高荣 : @ssssurejing
太阳kiki : 阿大葱油饼 要有耐心才能吃得到[笑cry] 老上海的味道 我觉得比小笼包 生煎更好次的上海美食
哥哥-aihily : 回复@涅瑟唔了:嗯啊，谢谢
夜静心澈 : 回复@谢旪榭:[good][good][good]
xuhahar : 所以说米其林如果来中国评估计要吃十年
lv美包世家 : 好想吃
lv美包世家 : 好想吃
Ja德满奥利奥 : 回复@要一本正经的胡诌八扯:快去吃 好吃告诉我 我也去～
MManBBA21 : 酒香不怕巷子深啊
7-28到底多远 : 回复@7_Vampire:[挤眼]那天我还看，太原有直达西藏的火车了
wangluoqin_ : @我叫郝赞
安小妞向太阳 : 店面地址在哪里啊？
麻雀-耶 : 上海的葱油饼真的[good]
雨诺尔 : 一般正宗味道，好手艺，都不是那种大门面，装修豪华。只是简简单单面铺，甚至看起来有些老旧[微笑]
神啊上帝啊以及老天爷啊 : 在哪块，我要去吃[脸红]
雨诺尔 : 一般正宗味道，好手艺，都不是那种大门面，装修豪华。只是简简单单面铺，甚至看起来有些老旧[微笑]
神啊上帝啊以及老天爷啊 : 在哪块，我要去吃[脸红]
阿蒙是你叫的吗 : 回复@-刘hhhhhh:评论里找
LLLeline : @周游是掰咖 想去
Zurich_Maggie : 这个点，很饿！
某W姓小鲜肉穿衣显瘦脱衣有肉 : 啊啊啊好想吃可惜不在上海[泪]
博_格 : 回复@嘿一个鱼蛋:我刚刚百度了一下地方，有机会的会可以去买来次次
古月王黄 : 好想次啊！！！[抓狂][抓狂][抓狂]
Dream丶丶cc : 回复@mlxsjie:烧饼不都是这样吗。我觉得看起来很香呢
小鳗鱼暖暖 : 就是看着有点油
阿阿阿阿阿小温暖啊_ : 所以突然觉得花一生去做一件事也是很伟大的一生呢[心]
我不害怕落后那些幸福的人多少年 : 回复@巧克力小芝-:是了是了
那一对飞过沧海桑田的蝴蝶 : 我特别喜欢葱油饼，但是每次我妈妈都嫌做起来太麻烦！@咸鱼菲otato
托马熊 : 好想吃
烦恼都很低 : 回复@mlxsjie:我觉得看着很香啊
王嘎嘎的小尾巴 : 最后一图是什么鬼
额丶丿婷婷爱博博 : 看饿了，特别爱吃这种饼，越吃越香
最爱猪肉卷的生菜 : 老大！您倒是po个地址来啊
Abby_Grain : 回复@桃之妖妖bao:在哪里
7_Vampire : 回复@7-28到底多远:我又想我们除了上海，也可以去周边的地方啊，我看苏，杭都超近的[鼓掌]
wjkzmy : 好想吃[太开心]
tiansewu天色吴 : 妈呀馋死我啦
最爱猪肉卷的生菜 : @小P的媳妇   老板我好爱这口 你喜欢不
平安三明 : 术业有专攻，行行出状元
红家阿九 : 讲真，葱油饼真的超级好吃
桃之妖妖bao : 男朋友排了5个小时，还是没排到[笑cry]
SHYK-----SHARK : 感觉我姥姥做饼也长这个样子………
武松打老虎 : 这个老伯做的饼很多人排队德，节目也是很久以前看了
黄桃味的凤梨罐头 : @凤梨味的黄桃罐头 香
乐乐8lele : 我也想吃[色]
朱晓薇12 : 饼香不怕巷子深
只为及笄 : 喜歡吃
宰增送宰 : 图片评论 
做平凡美丽的女子 : 一定没有卫生许可证
heyyitsme : @猫小鱼_7
涅瑟唔了 : 回复@哥哥-aihily:茂名南路159弄2号后门(近南昌路)
小鼠标的呵护 : 回复@hello晴girl:你不会是潍坊的吧！潍坊火烧
山山的酒 : 很想吃！[爱你]
涅瑟唔了 : 回复@单细胞生物-Z:如图 
小鼠标的呵护 : 怎么看着这么像潍坊火烧啊
小茜原来是这样的柴柴 : 回复@姓氏郭-:[爱你]
雄起的橙子 : 喜欢这种淳朴的味道～
StillAliveKV : 回复@帅帅比你帅:评论有
hello晴girl : 这在我们山东就是火烧阿[馋嘴]一口气吃十个妈呀都不够
用户5872076731 : 老伯加油
seeeuAgain : @amoklin [doge][馋嘴][馋嘴]
ZHANG--大可爱 : 回复@mlxsjie:嫌难看可以不吃啊！又没人强迫你，还有，不得不说，葱油饼就长这样，爱吃不吃，但是是真的好吃。
叶良辰樣 : 回复@mlxsjie:真正的美食靠的是味道征服味蕾，好看的不一定好吃
mini-baby酱 : 我吃过[doge]
谢旪榭 : 上海人，喜欢吃葱油饼，我们食堂只要做我肯定买两个！但是，不一定适合每个人的口味！[微笑]
打豆豆的妈咪 : 好想吃
水果姑娘Ariel : 回复@Halfdegree_:我喜欢[doge]
没钱的死洞 : 寿司之神[doge]葱油饼之神
温四羊 : 看着就好吃
陈栀栀和王弯弯 : 回复@王弯弯婉婉丸丸:那就嫁过来咯
7-28到底多远 : 回复@7_Vampire:哈哈，最近总是在看上海旅游必去的景点[笑哈哈]不过我没去那今天会做规划的[笑哈哈]
Lan-Max : 看着就好吃
南风过境Yan : 相比如今的添加剂这样的原生态和坚守更是保留了食物的原味与对中国历史的尊敬。
Lan-Max : 看着就好吃
南风过境Yan : 相比如今的添加剂这样的原生态和坚守更是保留了食物的原味与对中国历史的尊敬。
我和早饭分手了 : 我家是四川的，我们那边有个李家锅盔，也是每次都排队好多人去买，打锅盔那个老爷爷从早上打到下午，最喜欢的是细节是，他会在中午时段，买10多块钱的牛肉加一瓶劲酒，边打锅盔边吃牛肉在顺带喝一口酒，好带感！！
自己一人也要拼命努力呀 : @Ashee_板栗 吃！
苍狗与喵 : @ii宿命中妥协 [馋嘴]
李病猪 : 匠人精神！为阿伯点赞[爱你][爱你][赞][赞]
每天刷leetcode的Jiao : @郑炜lilac 你吃过这家没～?
-铁锤妹妹 : @喂__小番茄
-TSUKI- : @粗暴的北大西洋暖流 我现在看什么都觉得好吃
可笑的人类i : 很多节目都出现这个
-TSUKI- : @粗暴的北大西洋暖流 我现在看什么都觉得好吃
可笑的人类i : 很多节目都出现这个
傻瓜傻Zz : @ZhangTINGHUI_
乔小守 : 你去试吃一下吧@从11区来的Hatto先生
MR段某某 : 匠人[赞][赞][赞]
莫生气12138 : 评论里事儿妈不要太多，爱吃这个的人人家就是觉得好吃你管得着吗?你嫌油大你不吃就可以了啊，咋别人表示爱吃个东西，还有人挑三拣四在这里找存在感呢?讲真这种油饼对于我们这些在外奋斗的青年们来说，这就是小小的乡愁
罪恶王冠宇 : 我饿了
Dr丶Water有情绪 : @RainaLovesPink
iSEVEN17 : 卖相一点都不差啊，看起来好美味[拜拜]想吃
Regina-13 : 看着好有食欲[太开心]为老伯点个赞
iSEVEN17 : 卖相一点都不差啊，看起来好美味[拜拜]想吃
Regina-13 : 看着好有食欲[太开心]为老伯点个赞
傳說中的黒岕貓聖 : 豬油香蔥 大多數都愛的味道 希望老伯生活美好[强]
-南方姑娘bigbeauty : @cccccccccccllllllllllll
别再和我提关于幸福的事 : 上海的饼不好吃
为明天而奋斗的Chris : @dwy邓邓的遐想 @就是我啊ya
小麻雀de : 在上海哪里？？
lingli1992 : 图片评论 
非陌上花不开 : 回复@CccchEnnnn_:茂名南路159弄2号后门 我复制的
早就说够了再见 : 然而吃过的人都说没有那么好吃，你们开心就好。
早就说够了再见 : 然而吃过的人都说没有那么好吃，你们开心就好。
s-bilibalaaa : 这么好吃嚒？在广州的真没吃过。
江山的世界也疯狂 : 好想吃[色][色][色][色][色]
Lucy1222 : 回复@我怎知道你爱不爱wo:你家的有人排队买吗？
Just-TV5XQ-Love : @一点凉沫 我也想吃
Co丶Leo : 好想去吃一下
一头移动的熊 : 好想吃[色][色][色]
月下弹支小夜曲 : 阿大葱油饼
谢旪榭 : 回复@夜静心澈:再多说一句！伯好像孤单一人，儿子有时陪他吃饭，每天驮着背走来走去做饼！做饼在我感觉是他的信仰了！
乔_小_荞 : 我们就是缺少了传承，哎～年轻人都不愿意干了，这些老味道慢慢都消失在了老巷子里。当年那些老房子都在拆，当年那些老味道再也找不回来
乔_小_荞 : 我们就是缺少了传承，哎～年轻人都不愿意干了，这些老味道慢慢都消失在了老巷子里。当年那些老房子都在拆，当年那些老味道再也找不回来
张小左sara : 在哪呢？
卓睿SAMLY : 敬业！！
严肃的小小树 : 对美味的执着
瓶子莉莉q : @Vesey 你可以去试试
lunpan : 真的有人腰能弯成这样，比如我外婆[泪][泪][泪]
_洛雯 : @我是无敌闪亮小黑娃
一个行踪隐匿的朋友 : BBC很厉害吗[微笑][微笑][微笑]还惊动，
帅帅比你帅 : 回复@StillAliveKV:在哪？
姜妹妹呀 : 这世界上大部分的奇迹只不过是普普通通的人们将心意化作了行动而已.现在电商平台鱼龙混杂.选择一个好的平台十分重要.所谓的免费都是陷阱.而没有二次收费并且让每一个入会的宝宝们都赚到钱才是我们追求的.愿我们都能成为自己养活自己的小仙女! 
姜妹妹呀 : 这世界上大部分的奇迹只不过是普普通通的人们将心意化作了行动而已.现在电商平台鱼龙混杂.选择一个好的平台十分重要.所谓的免费都是陷阱.而没有二次收费并且让每一个入会的宝宝们都赚到钱才是我们追求的.愿我们都能成为自己养活自己的小仙女! 
c将将将j : 回复@_VinRouge_:nhk的好像
柠檬派大 : 好想吃
小炫疯子 : 回复@老娘不就是懒的改名么:[微笑]你居然抓不住我的点
Queen85078 : 在哪块？？
叫我大大青青青_DDD : 回复@刘叔叔很忙:葱…油……
玫瑰病了酷酷的 : 好想吃啊！具体在哪，有时间去解解馋[群体围观]
爱吃西红柿的南瓜 : 感觉很好吃[害羞]
呆鱼在游 : 吃过，大冬天排了一个多小时，就为这张饼
门上有人 : 每个美食都背后都有一段情[心]
我怎知道你爱不爱wo : 这不就是光饼吗？我家多的要死………
Lucy1222 : 佩服这样的人 工匠精神[强][强]
小鱼鱼love游泳 : 我要去[偷笑][偷笑][偷笑]
小兔子的舒芙蕾 : 回复@_默默的小丸子_:好不好吃呀[馋嘴]脆脆的？
我不能摔倒地会痛 : [good]
HeyyyDiear : @纯什么子
柯南道尔_伟_法号牛逼 : @你微笑的时侯很美
lizlill : 看着很好吃诶
ThyHx : @通通结局
Rita--请叫我小麦33 : 小时候的回忆，长大了很少吃了，真的很好吃
Rita--请叫我小麦33 : 小时候的回忆，长大了很少吃了，真的很好吃
期待一趟精彩万分的旅程的姜小丽 : @倔强的炉包 快去尝一尝
夜静心澈 : 回复@谢旪榭:[作揖]
马丁是阿拉丁的丁 : @王梓臣__ 想吃[悲伤]
圣丶旅程 : 回复@我想长到一米七爱发呆:感觉一直弯腰做饼就慢慢这样了
_默默的小丸子_ : 吃过…以前没限购，有些人会买20只[笑cry]最怕就是这种直接一锅出炉的都买走…然后等就要等很久…最长也等过3个小时[笑cry]不甘心的本来要买2个，最后买了4个[害羞]
张沐哲n : 就是样子不是很好看
啊迪wq : 好想吃[馋嘴][馋嘴][馋嘴][馋嘴]
银大妈 : 有能耐你丫发地址啊！[doge]
Ta它Ta它 : @倾子矜
Ta它Ta它 : @倾子矜
落花生酥心糖_-_ : 地址地址？？！
wanderer-sone : @大邱金泰恩 想吃老大爷做的葱油饼
U丶an啊 : 我只想知道在上海哪！吃货抱紧我[doge]
Oooooooooooooooo__ : @王岳嵩 好想吃这个[哈哈]
stupid_liarOo : 好想吃
华丽丽7087 : 想吃
正午阳光36度 : @浮生锦末央 下次去上海记得试下[嘻嘻]
我想长到一米七爱发呆 : 回复@克兰德思特里:可是其他图片都是差不多的姿势，怎么这张就怪怪的！反差太大了吧！
甜蜜的nana : @栁少爷
