绝顶美男子刘烨 : 落后就要挨打，勿忘国耻，振兴中华！
大学生通讯社影视编辑部 : [中国]铭记历史 勿忘国耻！！
奋斗中的待业女青年 : #牢记九一八#勿忘国殇，吾辈自强
不想说话的粉丝 : 铭记历史，落后就要挨打！吾辈当自强
樊明明 : 勿忘国殇，吾辈自强！
M84697 : 铭记历史，不要忘啊。都是一寸一寸鲜血生命换来的
甜美系的冰美式 : #九一八85周年#勿忘国耻，爱我中华[心]
抹茶mochaa : 转发微博
fly夏天的凤凰 : #牢记九一八# 铭记历史，勿忘国耻！
flying翔爱发呆 : 勿忘国耻是让你努力工作建设国家，不是你吖狭隘的民族主义。
一位不愿意透露姓名的郑凯小朋友 : [蜡烛]
张哈哈喜欢林俊杰 : #牢记九一八#
未入戏丿 : 现在有人又回到了当初跪舔洋鬼子，崇洋媚外的东西[微笑]
牙买加国最白的人 : 每一个这样的纪念日，都会默默地想起一个人，一些事儿～
鈴木信長 : 丢人现眼的渣浪一边说着爱国一边系统表情连天朝国旗都没有[中国]还得靠老子自己打[怒骂]
一笑奈何的微微一笑 : 转发微博
嗯做一个有用的人 : 落后就要挨打！铭记[祈祷]
批风抹月活神仙 : 腐败必然挨打
倩倩快乐miffy : #牢记九一八# 勿忘国殇 吾辈自强
VIP中的煖風撩亽醉 : 嗯，说的都对！
唯爱杨洋LA8 : 以后不要再去日本了，日本杀死我们那么多同胞
Superlady艳 : 这可以说是我们中国人心中的痛，永远要记得，落后就要挨打，我觉得国民意识太薄弱了，像这种纪念日，可以多放宣传教育纪录片，少播些娱乐方面的东西，让我们祖国的未来也铭记历史，以史为鉴……
雁过无痕风有情-生死两忘江湖里 : 勿忘国殇，吾辈自强！
风过oooo飘凌 : 勿忘国耻！
-16卍 : 勿忘国耻
漾安魔法袋 : 我记得
杨有才真帅_ : [祈祷][祈祷]
吖吖宝贝贝 : 勿忘国耻
古人舒歌 : 勿忘国耻 缅怀先烈 [中国]
米西儿121 : 希望国家的强大能紧紧和我们联系起来，我们不想只是观望国家的强大。就像一个贵州山区的孩子看到上海的越来越繁荣，心里什么滋味……加油，我的祖国！
用户3626380410 : 今天是九、一九勿忘国耻日，因为上夜班，今天早上被防空警报声吵醒，是合肥市长丰县城关第三中学的防空警报声，学校把全体师生召集在学校操场，本来利用九、一八这个特殊日子，开展一堂爱国主义教育课，可是一个国立的九年义务教育初级中学，连一个爱国话题和只字片语都未提，(未完)
爱吃面包的兔子酱 : 国耻勿忘  更不要忘了身为一个中国人的尊严和骨气  [祈祷][祈祷]
白儿在晗风中迷鹿了 : 今天考试的时候听到了防空警报 不忘九一八[拳头][拳头]我是中国人[拳头]
22013991hh : 只有自我強大 才不會被欺負[赞]
樊明明 : 勿忘国殇，吾辈自强！
不盈不科 : 国殇不忘
丢手绢的娃娃 : 铭记历史
兔小狗1 : 怎么可能不记得
初言马佳 : 转发微博
Choco_Ying : 转发微博
永嘉县江北亲仔纺童装厂 : 转发微博
家住乡云里 : 小时候看过731的纪录片，吓哭了，出离的愤怒……罪恶的日本侵略者，不反省的现代日本我拿什么原谅你？
Superlady艳 : 勿忘国耻，振兴中华！现在的小孩子们都开始看韩剧，被韩剧洗脑了，强烈支持广电进一步封杀韩国明星！[拳头]多关注关注新闻，他们部署萨德的时候，可从没考虑过，中国对他们有多有好，多少年轻人喜欢他们的明星……
骆驼沁池 : 勿忘国耻，缅怀先烈。
努力努力的阿花 : 少年强则国强！勿忘国耻！！！
风云人物-72706 : 我的家在东北松花江上，那里有森林煤矿，还有那漫山遍野的大豆高粱，918-，918-从那个悲惨的时候，我的家人姥爷、叔婶子都是日本人害死的，叫我如何能够忘记国耻家仇，让我们世世代代牢记918@刘涛tamia: [蜡烛][蜡烛][蜡烛] @新疆天地科技发展有限公司
遇见黄其淋 : 勿忘国恨
70s-ciao芳 : 转发微博
落花无意飘香时 : 勿忘国恨。
栾小昂ang : 铭记历史，勿忘国耻，我在黑龙江！
一个人的执着321 : 传递，铭记。
LEJF : 回复@六个桃咂:铭记历史，勿忘国耻！
三水哥哥说 : 去年在东北听过一次鸣笛，那种震撼直击人心。国耻莫忘，赤子之心莫丢。
别撒泼 : [心]
T应飞fly : 转发微博
嫌弃夫妇的最长旅途 : #牢记九一八#
Ice___berg : 勿忘国耻，吾辈自强！[心][心][心][心][祈祷][祈祷][祈祷]
ZZouyi : 勿忘国耻！
六个桃咂 : 勿忘国耻，珍爱和平[蜡烛]
baobao_116 : 勿忘国耻铭记历史！
扩充心管 : 铭记！
swagswagswag黄子韬 : 转发微博
520过儿过儿过过过 : [祈祷][太阳]
青椒炒纳豆 : 铭记历史！
姜三胖_ : [围观][围观][围观][围观][围观]
余磊3715 : 有从不同角度看待问题的就删掉我的评论，要求大家的观点强行一致。新浪微博留下这个功能就是言论自由的“防火墙”。
余磊3715 : 有从不同角度看待问题的就删掉我的评论，要求大家的观点强行一致。新浪微博留下这个功能就是言论自由的“防火墙”。
黄鹤楼上吹玉笛 : 勿忘“九一八”，吾辈当自强！
初恋七里香 : 永远铭记
古川夫人北海道 : 勿忘国殇，吾辈自强！
倩女黄蓉 : 勿忘国耻
赵小珩珩 : 我操你奶奶小日本鬼子[怒骂]
双人鱼的周 : 回复@CANLLER:你走开好吗？超级烦！
宣城那点事儿 : #晚安宣城# 各位，晚安。[微风][微风][微风]
橋頭司馬 : 警钟长鸣！日本军国主义准备卷土重来，我们准备好了吗？
诺-已成沫 : 没有他们就没有今天的我们
咩咩小羊毛静 : [拳头][拳头][拳头]
LIZA造美工作室 : 我只关心 房价又涨了
Miss__璠小姐 : [蜡烛][蜡烛][蜡烛]
吙草 : 918，对每一个中国人来说，都是一个具有警示意义的日子。1931年的今天，一群日本军国主义者将魔爪伸我们祖国的东北大地，悍然发动了震惊中外的“九一八事变”。继而，东北沦陷，华北告急，中华民族到了最危险的时候！ 是共产党人在艰难岁月的不忘初心，是无数仁人志士的艰苦奋斗，才造就了我们![蜡烛]
从今天起做个勤勉的女子 : 九一八，人不能忘本，更不能忘记历史重创的面目全非！居安思危！
大大大大大大大Ice : [心]
呲獠牙 : #牢记九一八#勿忘国耻 警钟长鸣
宁德市检察院 : 【如果你记得今天，请转发微博传递历史！】85年前的今天，1931年9月18日，“九一八”事变爆发。14年间，大片国土沦陷，3500万同胞伤亡。鲜血与抗争写就的历史警示国人：落后就要挨打，发展才能强大。今天，转发微博：#牢记九一八#，勿忘国殇，吾辈自强！
徐茜茜- : 记得住 而且今天麻麻生日 绝对记得住[蛋糕]
爱新觉罗_蛋卷儿 : 9:18时又听到了防空警报声，勿忘国耻#牢记九一八# ！！！
海淀区没有昵称的天空 : 勿忘国耻，吾辈自强
罗大奔 : 不能忘
爧閽旅者 : 請問還有人記得國共內戰中困長春，活活餓死的三十萬同胞麼[蜡烛][蜡烛][蜡烛]
良衣益友1303567463 : 日本鬼
木棉宇 : 记住心安
有條底褲才風流 : 日本現在最不好戰。中國搞不好房價，釋放屌絲軍的最大出口端就是戰爭。勿忘戰爭觸發因，民富軍强國有責！。
六大神兽www : 勿忘心安
雪紫w : #九一八，九一八#
雨巷的小兔 : [心][心][心]@骑在命运的脖颈上：“一个国家的繁荣，不取决于她的国库之殷实，不取决于她的城堡之坚固，也不取决于她的公共设施之华丽；而取决于她的公民的文明素养，即在于人民所受的教育，人民的远见卓识和品格的高下。这才是真正的利害所在，真正的力量所在”。
木九幽木槿 : 要让中华瞩目，慰我华夏英魂！
木九幽木槿 : 要让中华瞩目，慰我华夏英魂！
-安紫凌- : 吾辈当自强[蜡烛][蜡烛][蜡烛]
草莓团笙 : 铭记历史[蜡烛]
我是柚青儿 : 愿好人一生平安，918，一起怀念...
臻冶察东 : 这个日子我们不应该忘记的
一只会发呆的猫 : 自强
愿我们足够强大 : 定将足够强大
Vanessa_FY : 铭记历史，吾辈自强[拳头]
廿四知秋 : #牢记九一八#
暗黑小骨 : 历史不应该随着时间的增加而变得淡化！吾辈自强则国强！
展望太空 : 转起来！更要#将反腐进行到底#！
尉玄磊 : 关注
张进智 : 铭记历史，珍爱和平！
Natashaqq : [国旗]不要忘记，这曾经是我们的耻辱
幽梦在水一方s家优感 : 不能忘记耻辱，但也要笑着前行
2010-我不知会遇见你 : 勿忘国耻，吾辈自强！
一直不会变jdni : 呵呵，赞一个
穆素素素素素 : 牢记历史 勿忘国耻
写诗的南瘦 : 转发微博
峰嘉瑛 : 好高级也
半大个妖精 : 记得、铭记。不想转发
妖精一只3745 : [许愿]勿忘国耻，祈祷和平
白头山三胖跟帖处 : 转发微博
nianyixinan20132 : 勿忘国耻！
瀅婕 : 带着祈祷，希望明天会更好
听说数学考试专治各种不服 : 勿忘国耻，吾辈自强。
沉积岩的欢乐 : 怎么可能会忘[拜拜][拜拜][拜拜][心][心]
哲远c莫筱 : 918铭记历史
孤竹沐雪 : 发展才能强大
枝亨舒弘 : 太赞了
miuburberry : 这个日子，真的是刻骨铭心的
Luoyayuan : 吾辈自强！
qianyi媛 : @人民日报
琉金火铃_661 : 天佑中华，一起默念平安[国旗]
林儿越苏 : 这个必须转
舟鸣妍 : 看来感觉不错
AngelLily007 : 转发微博
AngelLily007 : 转发微博
波哥huang : 曾经的屠杀，让我们汗颜，今天，让我们共同祭奠
漳州消防 : 我们记得[话筒][话筒][话筒]
快乐crystal的主场 : hold不住了
八零后先森 : [微笑]不要光转发，实际行动才是真理。
萌系男的自我鉴定 : 勿忘国耻，永记心中！
小小兔也疯狂 : 不要忘记这些苦难[蜡烛]
人生幸福美好享乐吉利合心意善喜 : 历史和事实已说明了。回到今天现实人自身也不是落后体，一旦成为落后体则一切美好的生活即被灭亡。人是美好生活的胜者，美好生活就是属给人类，我们自身不软弱更强大则伟大的生活即来，困难远去。
潘壹秋_801 : [国旗]向那些年遇难的同胞，致以深深的缅怀
萌晓赫 : 为同胞们祈祷，心系此，希望安好
ada-chou : 漂亮。。。
赵丽球喵 : [蜡烛][蜡烛]
Kmoon-暖暖爱眼 : 勿忘国耻，兴我中华，迟早灭了它小日本！！！
很奇怪我爱你LXC : [强壮][强壮][强壮]
半河仁愈 : 但愿天下再无战事，和平铸就未来
大学生通讯社影视编辑部 : 勿忘国耻！吾辈自强[威武][威武][威武]
毛雨嗒呀 : #牢记九一八#  勿忘国殇，吾辈自强！[强壮] 
任世强gg : 牢记历史，勿忘国耻
L鹿wzj闵 : 勿忘国耻，铭记于心，振兴中华，
奥娜莉多 : 纠结的心，难以平复[蜡烛]
