暗河96 : 用水简直太道德
端小囡 : 回复@Heartbeat_心跳_:哈哈哈，你的头像～我还是点进去看了[doge][doge][doge][doge][doge]
LIUSICHAO : @熄了灯-
杀心成焚_ : 回复@短头发de胖子2012:心疼一秒钟[doge]
thouJ : 看到这个。。笑得不行
客官醋来了 : 我们小区大门口每天晚上9点结束
核桃设计 : 哈哈，真是一场好戏啊（娇媚）~
mengyang24997 : 这帮大妈跳广场舞不反对，但是请把声音关小点！毕竟还会吵到别人！
_NcOla_ : 确实很麻烦啊，有时候身体不舒服想早点睡觉根本不可能！我觉得这样很解气，我就没这个脾气[纠结]
糖果店胖子 : 不是现在有些地方都各自带着耳机，耳机里面放的同一首歌曲，这样也就不会相互影响了吧
撸撸顾 : 回复@旦夕离途:你应该是个孤儿吧
我是loulou阿 : 说实话，我有时候也想这么干。
素面妖娆16498 : 跳吧没事，成都房价就全靠这些广场舞大妈了，不然这个涨势老百姓吃不消啊！
总有苦海没有无涯 : 有时候心情急躁的时候，想静静，妈卖批都晚上9点都还在跳，比较上头，
Reserva2 : 哈哈哈，你知道楼下大妈的儿子是谁吗？随便射，搞事情
tiny丸子 : @贱人魏W
弹棉花的陈二郎 : 广场舞不分地方才没道德，打扰别人休息还倚老卖老
orange的味儿 : 回复@经过许多年:棒棒哒
别人家的男朋友灬哟 : 回复@BRRR1NG:[哈哈]其实主要想表达的就是尿她们才过瘾
晓心11 : 有点意思.... 这人还不错 没泼硫酸 只是象征性反击 还算有创意。秀才遇到兵 有理说不清 只能靠行动说话了
出淤泥而一身泥 : 这俨然已经成为社会问题了，不知可否多建些公园让她们去公园里跳远离居民区？这样大妈跳的开心居民也不受影响。比起广场舞大妈我更受不了高铁上大巴上用手机看电影外放的，能不能自备个耳机？
依然偏执狂 : 以后老了也要做个受人尊敬的老人
抓住一只叶不羞 : 落荒而逃，哈哈哈哈哈
QQ_Gu : 怎么说呢，非常支持水枪方，可以的话我想去当啦啦队。。。[思考]
L-Xiao海 : 道德绑架  扰民要不得！
代什什 : 干得漂亮啊
Srihanna : @Itssyn  真是一场好戏 哈哈哈
狼也玩微博 : 一是城市公共休闲空间少；二是国民整体素质低下!无论哪个解决好了问题就自然没了!
彬儿kwb : 建议政府给弄个室内场地，真的太扰民
经过许多年 : 回复@经过许多年:@orange的味儿
或许烟 : 回复@甜到哭:那时候的红卫兵差不多就是这个年纪
丸山泄领 : 图片评论 
之子竹 : 老年人的活动项目我是看懂了，那个扰民就喜欢哪个，甩铁链的我也想不通
整夜-雨香 : 回复@A-LuXiaoLu:买条野狗，谢谢！
经过许多年 : 对战20分钟 你不是最喜欢这样的戏
iniv : 跳舞的时候她是红卫兵，挤公交的时候她是弱势群体。
请叫我橙子哦 : 回复@A-LuXiaoLu:[晕]我家这有人买那个窜天猴的花炮，对付一大早再楼下放音乐的大爷[抓狂]每次都把他的那个放音乐的大喇叭给弄坏，妈个鸡，就是他一次次一次过分。现在那里被物业装满了那种短短的铁棍，没法跳舞了
_甜妹妹zl : 笑死我了
最牛逼的只有社会 : 下次用你的小机枪射，还有味道的下次她们绝对不来了！[哈哈][哈哈][哈哈][哈哈][哈哈]
最牛逼的只有社会 : 下次用你的小机枪射，还有味道的下次她们绝对不来了！[哈哈][哈哈][哈哈][哈哈][哈哈]
小白它很白 : 我们这边有一个文体中心，专门有一个广场是跳广场舞的，差不多跳到8点30左右就结束了，而且音响放的也不是特别响，这就是个人素质问题吧，跟广场舞没什么关系只要不影响他人休息就好了
幺妹子的康锅锅 : 下次把管子接到化粪池→_→
我_举个栗子 : 这要是在傣族……大妈们会很开心[doge]
全民gossip : 只能说广场建的不是地方，城市规划无能[喵喵][打脸]
BRRR1NG : 回复@别人家的男朋友灬哟:你能尿二十分钟么[doge]
来自火星的乔当当 : 那天坐公交 两个老太太上来 我前边的两个同学给让了座 让的时候老太太们满脸笑颜 说谢谢 坐下之后 老太太们开始聊天 傲娇的说 年轻人就应该给咱们让座 让他们站着[脸红]
silent_honor_Ark_Knight : 广场舞上的龙虎，公交车里的病猫
茗茗如約 : 哈哈，好搞笑
一个当地十分英俊的男子 : 配图只服人民网。
小兔加白 : 我们也可以[微笑]@孤舟独树
爱搞事的睡神 : 上次去外国跳舞不是被人家拿枪赶来着
清谷001 : 催泪瓦斯呢[doge]
甜到哭 : 回复@战略忽悠局山东分局:那时候最早七零后的小青年都赶潮流跳迪斯科，现在最老的七零后才46岁，他们变老了吗？你这不是胡说八道强行灌鸡汤吗？
Flower比比花儿慕么么 : 可爱[哆啦A梦花心]
可爱得没救了o : 回复@呆呆蝉:只要挤公交绝对能把人踩在脚下 上车后没座立马弱不禁风
碧云引风吹不断 : 回复@A-LuXiaoLu:你需要赏金猎人那里面唐嫣用的那种电枪！一枪一个！每天早上四点起来练手[哈哈]
杯中酒i : 家里住三十五楼，由于工作的关系作息时间一直不稳定，大爷大妈有时候玩的嗨了搞到晚上一十点。怎一烦字了得
每天都被自己帅醒zZ : 楼上洒水大妈说没道德…那你们扔石头呢？水顶多湿了衣服…石头呢？讲真…给大妈们安排个专门跳广场舞的地方吧。小区内严禁！不然真心吵啊
登上珠峰的鱼 : 来，站个痛快！
趁着不深sugar : 有勇气，做了我一直想做 却不敢做的事
陌上阡离 : 我是支持跳广场舞的，毕竟年纪大了跳跳舞也能活跃身心，但是最好选择无人的空地，音响声音也不要太响，我们这儿小区对面就是行政服务中心，正好有空地，大妈们晚上就在那儿跳舞，也不会太晚，基本八点就结束了…要互现理解
阳光下绽放的花蕾 : 我楼下每天晚上7点准时跳广场舞，1小时后结束。
维么斯 : 虽说别人犯错，不是自己犯错的理由，但若是不顾别人的感受，那也修怪别人给颜色看。
我就是小可爱Yummy : 不被道德绑架[喵喵]
Jeash0 : 医大门口[挖鼻]，
放肆晴天 : 干滴好，支持你
特罗姆瑟好茨呗 : 貌似记得上一次热评是：怎么不用开水？
特罗姆瑟好茨呗 : 貌似记得上一次热评是：怎么不用开水？
晓西2016 : 每天中午午睡时间楼下都会有几位大妈在那大笑！我当时想往楼下撒尿！
网瘾少女岛田李敏 : 泼开水[哈哈]
Mr陈奕坤 : 配图我只服人民网[doge]
叨叨盗盗123 : 泼得好！绝对支持！！整天小区都在跳 声音大的跟鬼一样！！！
莲续风缘 : 每次听见广场舞大妈的音乐都想去把那机器砸了，有必要开的那么大声吗，你们开心了别人就不用生活了吗，要唱要跳就去公园人少的地方跳，在住宅区跳啥，还说我们也会老，要理解老人，喵的，换我天天在你休息时去吵你看你还开心不
嘻嘻家的兔子 : 听说用音响放慢一个拍子就可以了[哈哈][哈哈][哈哈][哈哈]
NeverOMG : 配图我只服人民网。
Nicholas-杨 : 看中国大妈的这些形象
用户5nn54m2enm : 回复@大皮皮猫2013:说的你不舒服了，呵呵
用户5nn54m2enm : 回复@大皮皮猫2013:说的你不舒服了，呵呵
想去安联看场球XDD : 高分贝跳舞还说别人没道德？她在骂她们自己吗？
1llIIIll : 我是个手机永远静音，闹钟只有振动，听歌玩儿游戏都是戴耳机的人，所以真的不喜欢广场舞大妈们的喇叭
小兵团长 : 看到这个新闻我很高兴，终于有人拿出实际行动给大妈们(没素质的倚老卖老自以为是的老年娘们）上了精彩的一刻，唉呀我必须鼓掌啊～
梨妞爱上冰葫芦 : 每次天天听到这首歌最炫民族风，小苹果，江南style，广场舞音响声音很大越听越烦，失眠啊[生病]
胧胧月月 : 支持泼水，广场舞太扰民
起司猫大人oo : 为了跳舞，这群老人什么都干的出来[doge][doge][doge]而且也没人管管，我只想说射的好
矬燕 : 回复@何半仙:万一里面有丈母娘咧
神自不凡9266 : 好样的
化身孤岛的面包 : 直接扔note7
化身孤岛的面包 : 直接扔note7
都睡觉了木有人 : 我们这边的广场晚上八点一到 高音喇叭就在说八点钟到了你们改该散场了哈
圆圆其实一点都不圆 : 报警啊！
_Saltyholic : 吵不过大妈们，不然就是不尊老爱幼了，一个个泼妇样，最后小区装了门卡，结果那群人把们砸坏了[微笑]
只怪月光太曲折 : 我会泼墨水[微笑]
009999999相 : 直接泼粪
張小二G : 确实噪音很大，我家楼底下的大爷大妈每天跳到晚上10点多，还有在楼下放音响唱卡ok的。真是无语，他们平常是没事干吗。
我不是老刘- : @佳欣JIAXIN啊 可怜你还要被喷水
济源王屋山 : 影响到别人了当然不好
济源王屋山 : 影响到别人了当然不好
孔雀东南飞-路 : 最后一张配图[哈哈]
鹿柒柒哟 : 漂亮[微笑]
上官Baron : 干的漂酿[doge]
爱瞌睡的猫咪 : 泼的好！
随便叫个名字好哇 : @不爱喝温水Jiang [笑cry][doge]
夏木Shirley : 干得漂亮。
阿鲁啊鲁 : @忧郁的春花
炫酷狂魔芒果晶 : 还有那种大早上可劲抽鞭子的老大爷，声音简直跟放炮一样。。好不容易周末休息一下，大早上六点多这边跳舞动次打次、那边抽鞭子啪啪啪!简直反人类[大哭][大哭][大哭]
不二素家 : 干得好
炫酷狂魔芒果晶 : 还有那种大早上可劲抽鞭子的老大爷，声音简直跟放炮一样。。好不容易周末休息一下，大早上六点多这边跳舞动次打次、那边抽鞭子啪啪啪!简直反人类[大哭][大哭][大哭]
不二素家 : 干得好
呆呆蝉 : 回复@吃五碗喘:我遇到过那种为了去抢便宜菜大清早推个车车和我们挤公交的，上车时手一掀一大批人被拦在她身后上车就虚弱的站不稳需要别人让座的
米乘客眼 : 我只能说，干得漂亮
nahiones : 回复@_下雨天的汤圆:这是我想一直住在郊区的原因[眼泪][眼泪][眼泪]
小汀汀的面包桑 : 配图我只服人民网
来自火星的乔当当 : 干得漂亮
Archreer : 跳是可以跳 但是您得找对地方啊 像这种居民楼前大街上 肯定是不行的啦 公园广场什么的不挺好的吗
请叫我乡霸 : @陈枕流Syrup
请叫我乡霸 : @陈枕流Syrup
Mr_萧泽文 : 广场舞应该尽量选择在广场或者公园，如果在条件允许的情况下，可以一人买一对迷你蓝牙耳麦戴着跳，谁也不妨碍谁。
山有木兮木有枝_z : 只要不是开水，泼的好！实在太烦人！
艾蜜莉雅碳赛高 : 回复@Saaaaaaaaamuel:性感女性天天在你家楼下大声放歌我不信你还能受得了
Fyznlilys : 真的是声音蛮大的
赖怡帆v : 回复@FinalAutocrat:我们这边以前真有过泼粪的[眼泪]
_Saltyholic : 跑到别人小区里的水池边跳广场舞，楼上直接叫保安来赶走，高考前一个月天天跳到11点
TWO罂粟 : 不要再小区的广场跳，去大广场跳
红红火火恍恍惚惚哦哈哈 : 人民网配图真的没话讲[doge]
郭唔唔 : [失望]我也好想玩水枪，我感觉好好玩啊
LIE麋鹿 : 赶紧推迟专门用于跳广场舞的评价蓝牙耳机吧。这样想想蛮搞笑。一群人在那抖腿甩手的[哈哈][哈哈][哈哈]
总有刁民想嘿朕 : 最后一张图是几个意思？
張较瘦Zzz : 我只想说干得漂亮～@山椒烤大鱼 [阴险][阴险]
是徐不是许文雯 : 见过除了几群大妈广场舞混战，还有拖音响的大爷唱歌的吗？还没有伴奏哦[微笑]
科胡特克 : 时不常扔下两个瓶子，别砸着人为妥当~[doge][喵喵]
有狐璃 : good  job[嘻嘻][嘻嘻][嘻嘻][嘻嘻]
喵洛克福尔摩猫 : 配图只服人民网[眼泪][眼泪][眼泪]
三鹿丷 : 咱家楼下没这个吧@大豆721 [挖鼻]
二十麻神 : 跳舞的大妈没有公德心，不知道会影响别人生活吗，可以用耳机代替音响啊，做动作没关系的呀，还是内心根本没有公德这个概念。
石石石石石哈皮 : @刘酱酱-
鲍勃勃勃勃勃 : 回复@一条特立独行的大鱼:别的地方不清楚，温州这边丧事都要找个锣鼓队，小乐队之类的，唱好几天，虽然夜里不会，但是还是比较吵闹。
木幽兰鸢 : 回复@徐清之:宣传片有，央视新闻刚出个《生活辛苦，不如跳舞》现在除了宣传广场舞种种好，根本不管被扰的居民死活。被扰居民不辛苦？背债买楼还要天天被扰。换房？那请问谁爱买楼下天天广场舞的楼？找警察？警察告诉你跳舞无罪。
十三幺单吊幺鸡 : 广场舞大妈现在是全球最大的社团，你们惹得起那吗[嘻嘻][嘻嘻][嘻嘻]
苍蓝101 : 那样在楼下真的受不了，有神经衰弱的听了真的会烦得想撞墙
尐布丁的保姆王啧啧丶 : @小訾怪_Ars
如红酒般醇厚 : 就是的，跳也到不扰民的地方。
代表玥亮消灭ni : 回复@玉兰盛开时:根本不是，她们的声音是问题
mirrorCr : 只有我一直关注配图吗[喵喵]
代表玥亮消灭ni : 回复@玉兰盛开时:根本不是，她们的声音是问题
mirrorCr : 只有我一直关注配图吗[喵喵]
_下雨天的汤圆 : 跳广场舞真的很扰民好吗，声音大的离谱，天天过得什么日子，真的要疯了
大份面加倆鸡蛋 : 本来就是一天生活的休息时间，大妈们整天闲的晚上开始闹腾，大人小孩都难受！
科科LEEKE : 暴走的请不要逆行占道
泉水清澈2015 : 现在的大妈，用句网上俗的，是文革那帮人，变老了！别担心，在过三十年就好了
边走边唱的秒爷 : 回复@邹奇怪怪:关公境地也被占领很恐怖
安娜咔啦妮娜 : 如果家里有孩子，影响到我，估计我得用硫酸扫射了。都很累，提升一下装备，跳跳舞本身是好事，强身健体，不行带耳机跳吧
牜卖丿子壹个 : 我这里早上5点半一遍，晚上6点一遍[眼泪][眼泪]，我就是没有水枪
逗了隔壁- : 规划广场舞区域，互相尊重，有时候真的太吵了
Summersmall : 晚上的广场吵死了，老逼们请给世界一个安静！
张宝权起个短点名字不会吸引注意 : 你最后这图....没想到你是这样的小编！
饭茶茶 : 别说大妈了，我妈在家用电脑听的那几首歌，我的个去，她关着书房门听我都能奔溃喽。“你做了别人的小三”“姑娘姑娘你就要嫁人了”一天循环播放几十次。。。。。。我的妈啊。。。我的亲妈啊。。。。
酸GL : 确实听多了会很烦躁，主要是报警城管啥的都没用，又沟通不了的话只能自己解决
Tingx234 : 这群讨人厌的，文化大革命出来的厚脸皮，臭大妈们，接招吧！
倪彦祖的迷妹 : 广场舞挺好的，政府不作为，专门弄个广场跳啊。
点角看星空 : 真是对这帮大妈们没办法，早上7点就跳，晚上6点多跳到10点火，不累吗，
你说的喵是什么喵 : 回复@-P酱:所以很明显他们说的是在居民区跳舞的大妈 并不是说普通人的大妈
吐泡泡滴窝窝 : 我们小区是早上8——9晚上20——21并且音乐省也不大，十几个老太太也不扰民挺好的
舔芙蓉姐姐的卫生巾 : 虽然支持泼水居民，但是浪费水资源不太好，泼屎吧[怒骂]
哈哈哈哈哈快乐 : 太过分了  喷水就完事了？
哈哈君啦 : 回复@myp622:我看到了....
襄阳肖肖 : 回复@YJ_在旅行的路上:[笑cry][笑cry][笑cry]
吃瓜少年-- : 哈哈哈哈哈哈哈哈这画面感神秘呲水枪和老太太石头子的对决
你想要的幸福189 : 回复@又又又TMD帅了:[偷笑][偷笑]我们的大妈是五点半[衰][衰]
七夜谁听雪 : 没道德？没道德的人变老了。为老不尊
Hunieit : 莫名戳中笑点 
襄阳肖肖 : 回复@昵称可以吃么QAQ:晚上，一群大妈面带微笑安静跳舞，一点声音都没有，你说恐怖吗？哈哈哈哈
南南美人 : 我家楼下也是，不过是小孩投币一元的摇摇车，天天都是那一首儿歌，听了都要吐，哎，没办法
