Gg-mn : 回复@小芃童鞋:这个人 在好多微博下都骂同样的话
无敌蔡CAI : 还有可能是她不小心掉下去了，手机被别人捡到了
阿卡玛斯 : 求助腾讯马总
大懒虫的围脖 : 求真相！
我叫samson : 唉可怜了这女孩，
平国忠 : 人在外地就是坐车都得记车牌，必须通知身边的人或朋友
Aibaoqiang承诺 : 太可惜了
平国忠 : 能找到8月2日之前的微信及通话记录肯定会有收获
转身江湖远 : 为什么不打码
羽末丶 : 听说好友没均被拉黑啊[挖鼻] 
lukwhen : 白瞎了
梅州人在深圳 : 一个人的旅行，听起来很酷，结局往往很残忍
迈巴赫蜀黎 : 回复@小芃童鞋:装什么清高，女的自己作，把自己命搭了，留下两个白发人，尊重分情况，这种就得骂
小芃童鞋 : 回复@迈巴赫蜀黎:你嘴巴也挺臭的
秦叔银 : 红颜多薄命啊……
罗卜医生 : @Carol-Ting婷
vianboy : 失足少女[挖鼻]
迈巴赫蜀黎 : 死了好，免得学马蓉到处祸害人
黄河九十九道湾 : 他杀会把微信拉黑？
土豆遇上了番茄 : 我的妈
双子座的蜜小bee : 不要以为说走就走的旅行适合所有人
我是一颗派大星 : 一定要一场说走就走的旅行。
闵济宏律师 : 我等着看搜狐被告的新闻
猪游列国 : 不要独自一人出去
娜戀彭猪 : 可惜啊
龙小疯 : 前无征兆，微信拉黑，肯定他杀。
Darksweet : 华山，很危险啊。。。一个人去爬山都很危险
请叫我比干吧 : 怎么等到一个月了才知道立案？
沈炊烟 : 不小心失足？
冬日阳光_Justin : 恐怖！
Loser--丶 : 哎~
你是我的唯一qing : 美女陈律师雯
幸福的水晶百合 : 好漂亮的姑娘，是不是他杀
金牌小伙伴 : 小编忘记打码
小宇宙nj : 好漂亮，可惜了
-游就- : 漂亮的姑娘们注意了，别以为一个人说走就走的旅行是美好的，也有可能是死亡之行
我不是路人乙 : 悲剧啊
Tamia_爱唯久 : 改过来了 [笑cry][笑cry][笑cry][笑cry][笑cry]感谢我 感谢我
昌盛中华1 : 失联就代表死亡了[愤怒]
