心情迷宫tua : 一人我饮酒醉，醉把前车怼一怼，两人他不服谁，高速飙车谁怕谁。二营长，把老子的杨永信拉上来，这两人都需要治疗[doge]
让我永远活在CCAV里 : cnm看个视频都要下载新闻客户端才能看
SAMONTHEGROUND : 回复@Yedda-_--:那你撞过没
神龙摆臀 : 回复@CherryS_ShawW:你没看出我这是嘲讽？没看到我用的是问号？你能不能看懂我说的再评论！
Schlin施林 : 以后开装甲车上路[哼]
史密斯孟 : 只要不是女司机就更完美了[汗]
不苦恼 : 回复@Yedda-_--:就你这种 也不适合开车
用户j8m9ivxc0d : 回复@Yedda-_--:顶你！！！
灯泡擦巴鱼王 : @民zhu的道道
曾经的狗哥啊 : @微詹小博 斗气不好，要永远相亲相爱
Carol_000 : 回复@Yedda-_--:有个青岛电台王丽君（我邻居）就是这样的人。微博至今写着：我的前面没有路，我的后面是一条路
图书馆话题 : 画面上看白车确实是没事找抽型的
祥子子子aaa : 这肯定会连累他人，一定要抵制害人害己
漠于鑫dana : 回复@Yedda-_--:我每次超车好多人开的慢还不让你超，
噢天呐女神般的我 : 珍爱生命，远离智障[微笑]
阳光彩虹的梦 : 唉
英迈特光电 : 同归于尽吗？
春梦不多时 : 人一疯就完全不计后果
没有giligiliai我要死了 : 现在有些人真的是太自私了
onionthat : 来啊互相伤害啊[doge]
张先生注册不上 : 我大潍坊上新闻没好事。
地地道道华夏子民 : 以和为贵嘛，都是有家庭的，谁出了事都不好
Nick_哈哈哈 : 中国人由于缺乏信仰是世界上最情绪化的人种！[吃惊]
嘉浩兄Aphrodite : 以为自己在拍速度与激情9吧
一木姑娘i : 我还记得在高速上前面那一辆车停在中间，连个灯都不打[微笑]  特么差点撞上去我就呵呵了   原来他要转弯！！！高速走错路也不能没路口就停吧[微笑]
Pilot舒克 : 回复@Yedda-_--:对方有错，罪不该死。想到会致人死亡就没有敬畏生命之心么？
昭昭将夕 : 这条公路不是你们家的好嘛。想死死死远点。
wangzhaohua803 : 这算是“路怒”的最高境界了，真可谓“你要跟我发飙，我就与你同归于尽”。好可怕！一个人已经怒到“视死如归”的程度，肯定遇到谁谁衰，遇到谁谁怕。没救了！
情书笺 : 有时候我们会在想 这个世界是怎么了  为什么会屡屡出现这种现象  是人性的扭曲吗  还是道德的沦丧  这一切的背后值得我们每个人都思考
wuyue20012 : 看了视频？这是在高速公路上吗？
用户nqf5cqwor3 : 不当场撞死，可惜了[嘻嘻][嘻嘻]
CherryS_ShawW : 回复@神龙摆臀:你这什么思维？人口靠计划生育！靠什么交通事故？哪国交通事故少了？都是在控制人口？老美枪击案也是为了控制人口么？
冬天D太阳 : 想死别这么费劲两包老鼠药就解决了[阴险]
廖爸爸的微博 : 王思聪为什么喜欢找网红，因为在他小时侯，你们懂得，美女也很稚嫩，看脸不看钱，他对美女垂涎三尺，却被嫌弃太丑，被女的歧视男的欺负，所以他只能和臭屌谈游戏，他还发过微博说他小时候游戏冲过很多钱，别人在花天酒地玩妞的时候他只能躲家玩游戏，所以备受打击的他现在喜欢找网红从而弥补儿时的伤。
aI1212- : 王思聪为什么喜欢找网红，因为在他小时侯，你们懂得，美女也很稚嫩，看脸不看钱，他对美女垂涎三尺，却被嫌弃太丑，被女的歧视男的欺负，所以他只能和臭屌谈游戏，他还发过微博说他小时候游戏冲过很多钱，别人在花天酒地玩妞的时候他只能躲家玩游戏，所以备受打击的他现在喜欢找网红从而弥补儿时的伤。
神龙摆臀 : 中国那么多人，总有人嫌命不值钱！每年多少人死于交通！这难道是人口控制吗？
iskyg : 要死，死远点，不要害了后面的人。
佚名的girl : 想玩命还是走远点吧，别把高速路给堵了
苏038Jimmy_翔子 : 撞死一个是一个！开车也能斗气！
秋天的童话oooo : 回复@Yedda-_--:生气归生气，还是要理性，生命安全最重要，不能把自己的宝贵生命安全搭在贱人身上，他们早晚会遇到更狠的人。
yama逆境 : 严惩不贷
帅比孔律师 : 危险驾驶／以危险方法危害公共安全；幸好没有更为严重后果。
果果的守护2016 : 这种货让他们死高速上就得了
叫我鲁哥就好 : 人家命都不想要了，还会在乎驾照？搞笑吧
公主任 : 回复@南看臺的驕傲--德云红酒青岛总代:终生禁驾
雨燕1122 : 既然活的不耐烦了，就让他们死吧
南看臺的驕傲--德云红酒青岛总代 : 危险驾驶，吊销执照，追究责任！
Yedda-_-- : 虽然偏激了点，但大家开车的都知道，有急事的时候开车，很想快点过去，可是就有个人在前面挡你车，恶心你，这个时候心里真的是很气，要是真有那样故意恶心人的，遇到这样暴脾气的，撞死在前面犯贱的也不为过，，为什么要犯贱呢，你要开慢车你就让出来露让人家过，不让过还恶心人，不撞你也得打你
