沙漠老胡扬 : 什么情况，我想知道。
JiiinG_G : 警察[列车员]🏻叔叔是为了你生命安全着想 一定要守法 这是你自己的命呀
流浪的人-尚由 : 转发微博
Miss百步笑五十 : 假酒害人？
贾大肚 : @yesyesyesssss-  联系联系 卖她tr
小米是包子 : 脑子是个好东西
梦回流年42591 : 丑的都打了马赛克了，还TM萌。[doge]
瘾思忆 : 其实我觉得这样挺可爱的[doge]没大哭大闹要上吊 多美好的[doge]
星星星pigeon : 恭喜你，中奖了[鼓掌][鼓掌][鼓掌]
喵啊喵MIAO呜 : 哈哈哈哈哈
以前的放羊娃 : 这女的本来就长的漂亮
瘾思忆 : 哈哈哈哈哈哈有点想笑
浮云fuun- : 回复@恆昼:也可能是亲爹…
wsdgml : 总比那些撒泼的女人要强
LilChang- : 回复@小鹿曈子:[给力]
谢嘉豪_Uncle : Q7
小白兔的情人 : [笑cry][笑cry][笑cry]
蓝小喵flynn : @生命向我们的召唤永不停息 [哈哈]
孤屿Roy丶 : 666666666
AsDapuvhRNN : 回复@搞笑靓妹妹:不觉得啊 有些我只是说有些开玩笑说来搞笑的啊
R吾日三省吾身 : 不能用，用了就是两个人了
like看破红尘 : 还配合你演出的我演视而不见
啸宇-同学 : 哈哈哈哈她还剪刀手@管延杰-
策马奔腾的奶糖 : @焦虑大飞哥 @UnlceLazy @说好的大排呢
东风雪铁龙客户服务中心 : 我也是醉了
WKezzHi : 自以为荣，不知羞耻！
独孤木有剑 : 美颜相机:这是我做过的最大牌的广告[挖鼻]
独孤木有剑 : 美颜相机:这是我做过的最大牌的广告[挖鼻]
我不想拆穿-你 : 真醉了
碳酸钠纯的 : 丢死人了
王璟琦这个名字被占用了 : 最后严肃批评教育，和阿富汗交通大队大队长自罚三杯么[doge][doge][doge]
沐夏的风mz : 有病，得治
小鹿曈子 : 回复@LilChang-:是我
江锋同志 : 把交警的家伙都逗硬了。
木子姐姐L : 这个故事告诉我们，喝车不开酒，开酒不喝车[good]
Hello漂浮魔少女 : 现在我们的羞耻心越来越棒棒哒呀，呵呵
可爱的赵赵酱看不起垃圾的杜废废 : @24号我的信仰
可爱的赵赵酱看不起垃圾的杜废废 : @24号我的信仰
莹莹小蝎子 : 脑残年年有今年特别多
沈先森就是我 : 还是乌鲁木齐的，
I古月先先貝I : 希望交警是给她用的美颜相机，了却她入狱前的最后心愿
Paradoxesss : 怎么办 有点可爱
注册会计师张浩 : 回复@余蛟16740:新疆第一啤酒。
那我就叫费劲吧 : 醒了就晓得了
K城市雕民K : 中国的美颜在世界整容术中占据了举足轻重的地位
智障的阿俊 : 配合的美颜了一下
毁灭兔 : 智障
婉余an : 等她醒了之后[笑cry][笑cry]
单亻徐只是单人余 : 回复@快手陈:现在好多了
琳_赵 : 醉驾是对生命的不负责！无好感。
开心的一塌糊涂 : 回复@成小韶念去去:二货
-阿星酱- : @谷小豆豆豆豆豆 @谷小豆豆豆豆 [噢耶]你看你看～～～
TIAN_TyiAN : @喜欢吃鱼吗TuT 叼不叼
地球村熊孩子 : 富家小女孩
日床小能手 : 这是个广告
SherlockRojers : 不是很懂你们年轻人
有嘉折首 : 回复@冰鎮金魚燒鮨:醉酒驾驶还算没有闹事？
---Mgy : 多大点事？厦门台风时候不见你发，厦门人顶起
辕少快取我屠龙宝刀来 : 牛
金枕棉 : 第一张笑得好开心，虽然是酒驾，当严肃处理，但感觉这姑娘挺可爱的[哈哈][哈哈][哈哈]
金色飞哥 : 蠢货，还要摆拍，过80你也够厉害的[赞]@人民日报 @中国新闻网 @中国之声 
我要继续上岸 : 开q7,,,也就不在乎了吧
CrimsonPhoenix : 哈哈哈可以可以，可以关起来了，谢谢
SamClaflin孩子都生了 : 奥迪
汤寅生 : 回复@Liiye_:没呢！我就是回答了1+1=2的问题
汤寅生 : 回复@Liiye_:没呢！我就是回答了1+1=2的问题
2011gengda : 你咋不脱光了拍呢
金阳枫叶红 : 长得丑，只能这样了
土豆香蕉喔 : 不管怎么样酒驾都是在拿别人的生命开玩笑!!
薄酒阿 : 哈哈哈哈想知道这姑娘微博
我超级讨厌吃鱼 : 没想到我昌吉第一次上头条还是这种事。。
石海VIP : [哈哈][哈哈]喝酒之前我是新疆的，喝酒之后新疆是我的
l-whoyou : 有病
欢chong : 都醉得没仪态哪还有美貌在啊
BEBETTER-CREASY : 有钱人还是会玩
遗忘的鸟托邦 : 主要看脸，评论区风格都不一样了
梦很快乐- : 美颜，难道真的不能满足爸妈给你的相貌吗？那你可以内在美啊！
袁紫伊- : 丑人多作怪
成小韶念去去 : @开心的一塌糊涂
用户5608587097 : 妈的，召集全国交通死亡魂灵围观她，再让她看看酒驾死者家属现在过的啥日子。哼，跟玩似的，很多肇事者事后拿钱了事，1条人命就几十万，没事。
快手陈 : 2005年在新疆待了一年，发现酒驾很严重，不知道现在有没有改善[汗]
爱上你的小情歌 : 估计喝断片了
GEM-吳泽呅 : @阿阿阿-阿高浩伟 @hai钟海 @WLB忘不了 [doge]
柚西门 : 回复@鸵鸟_不会飞:酒驾看的是驾驶证 不是车牌 和车无关和车牌更无关了
好食材2016 : 真是没救了
BRIAN_zjl : 回复@我就是小熊啊:我的哥厉害了，禽兽啊，请带上我
泡-墨 : 醉驾我只服你[笑cry]
dx-多余的夕阳 : 条件反射[笑cry]
LEE早晨 : 醉酒驾驶要坐多久？
Jeremy_SHENY : 呀 又是个低能
小猴子的仙桃 : 难道可爱酒驾就能飞起来不撞人吗？
wilford2008 : 在中国有钱真好！
周周周周___ : 回复@是孙天琦啊:哈哈哈哈哈是我，我得把自拍神器拿出来
鸵鸟_不会飞 : 这是新A牌照，乌鲁木齐的车，和昌吉人民无关[怒][怒][怒]
阿诺-施瓦辛硕 : @硕硕的颜颜
六月喵小姐 : 确实是醉了
林比坚尼 : 智障
我就是小熊啊 : 我只想跟她酒后乱性[害羞]
年轻就要尽情疯狂 : 一看就是有钱的主，怕什么....
勤奋的辉哥就是灰太狼 : 不要脸有多可怕
smallrock : 看这图片……交警是满足她了？
Kiki就是我啊 : 哈哈哈@袜子杀手小PP
桑菲尔德的梦 : @猪头不回头 昌吉的！
那个求别打脸 : 警察[列车员] 叔叔的美颜就是厉害，五官都给美图没了
恒者唯胜yeh : 智障
-哎呦喂是你呀 : 回复@无公害KY:我们那好像没有代驾[眼泪]
柳园下的约定 : 新疆昌吉？？？？人民日报？？？？
Miranda_u : 新疆还好。一路畅通,马路上还没啥人.
LilChang- : @小鹿曈子 是你吗
Liiye_ : 回复@汤寅生:[doge]莫名其妙被撩了
Sally小花妹妹 : 又是奥迪[微笑]
IAmLittleLittle : 就只有我一个人觉得她是小三吗
IMCHAW : 心态挺好的[哈哈]
林夕9091 : @丢丢额丢丢
MiNi彪 : 看来是真醉了
只嘉 : 很毒
梦A380 : 第一眼看到的是她旁边的车，这女子不简单啊
ARoNg198509 : 奇葩年年有今年特别多[嘻嘻]
李明洋_____ : 可以开飞机了
美智阿 : 没毛病
啊啊啊扑 : 虽然很可爱，但是还是讨厌酒驾害人害己
二十一_y : 实力作死
闪电or坚果墙 : 拍得再漂亮也是要整容的命
zarafa_piupiu : 绝了我的姐，下次别这样上头条好吗[哼]
李秀佛 : 呀？還賣萌呢啊[笑cry]
髙然然 : 哈哈，一朵大奇葩
DK_夏天来了 : 抽血？
k-ris : 这人，不知道怎么说了[汗][汗][汗]
Chole冰冰 : 智障！
CYJ_CRYSTALCLEAR : 这是真的喝大了[doge]
ShamanAL8 : 啥鸟都有！啥仁都有～@小凯muller
小微薄放大镜 : 关7天，好好治治
打不倒的小怪兽_囡 : 醉了
国寿陈志阳 : 呵呵
撒啦嘿哟Jason : @懒熊君呀 [眼泪]
七磅_磅 : 第一眼就看到了昌吉[得意地笑]@大家cool
LIin瑞蓑梭 : 我的哥，12分没了呢，科一等你哟[doge]
6254889032461015塔塔酱 : 让我想到了破产姐妹[笑cry][笑cry][笑cry]
木乃伊Li : @Taciturn陶 咋和你一样逗[笑cry]
弓长程 : 为什么我觉得很萌
我是你泽哥- : 这不是卖萌...这是真醉了吧..
阳妞与龙少的爸爸 : 裤裆有味
M-雲龍 : @77认真学画画
致命一棍 : 没拉着交警合影就不错了[拜拜]
梦想是一道光 : 吊销驾驶执照，罚款两千元并拘留两个月，看守所待两个月啊，吃的什么干的什么你进去就知道后悔了
崔崔崔崔崔大个儿 : 确定这不是广告
wuli丝瓜 : 可以开车，但别在路上啊
东北大江_18496 : 牛果然是B 出来的
老司机CHenZQ : 酒驾谁都救不了啊
吃太多会睡不着 : 回复@拿一份爱给自己:就是感觉奇葩的人太多[微笑]
______九 : @妖妖小精
zaitu_u : excuse me？还有人跟喝醉的人谈脸皮厚薄、羞耻心、耍贱？你喝醉的时候也是大家闺秀大绅士的样子呗？你喝醉的时候也是清醒的呗？？虽然醉驾不对，毕竟人家没刷酒疯好么 🙄 至于么？？？能不能别那么刻薄？？？
zaitu_u : excuse me？还有人跟喝醉的人谈脸皮厚薄、羞耻心、耍贱？你喝醉的时候也是大家闺秀大绅士的样子呗？你喝醉的时候也是清醒的呗？？虽然醉驾不对，毕竟人家没刷酒疯好么 🙄 至于么？？？能不能别那么刻薄？？？
HD风扬沙 : 即使喝醉了也不忘爱美[doge]
寒风中争做可人儿 : 还有人觉得萌？酒驾不是犯罪吗？我天，我是无法理解马路上的潜在杀手萌在哪。去看看禁止酒驾的公益广告吧，犯罪之所以是犯罪，是有原因的。
青梦碎月 : 无可厚非 只是处罚力度应该加大 醉驾也应该吊销驾照[微笑]
lilicoer : 社会好疯狂啊哈哈哈
Darcy_达西先生 : 人生苦短，及时性感—美颜相机
Biubiu_jacky : 第一:酒驾开车的确不对。第二：全国每天那么多的酒驾被抓，怎么偏偏拿人家上头条？第三:喝醉了才会这样的，好吧[笑cry][笑cry][笑cry]黑别人的，你先问问自己醉酒之后的怂样[挖鼻][挖鼻][挖鼻]
青草爱吃糖 : 回复@克鲁鲁西:哈哈哈哈哈
许Zhixian : 美颜相机打了个好广告
人生一场不妨大笑开怀 : 中国马赛克打的多余，人家想露脸
寒露凝 : 喷她是因为酒驾犯了错，还心态好到觉得无所谓卖萌微笑摆pose吧？错了就应羞愧，不能因为没出事故就觉得没关系了
阿晟觉得工资太低 : @艾酱酱酱酱酱-3-
凤凰村黑皮 : 家中一条边境牧羊犬于9月19号早6点左右在上海黄浦区北京东路355号楼丢失，名叫巴顿四岁雄性对人极其友好，它通体只有黑白二色和大熊猫一样，最明显特征双耳尖尖上有对称白色，提供线速者重金酬谢，恳请 @警民直通车-上海 帮忙查看路口监控，从此一定爱党爱国爱警察，不在牢骚满腹说怪话。
Even沉睡 : @妖妖小精
鄭仲婕 : 回复@鄭仲婕:醉驾不好  好在没有造成伤害    应该嘴上积德
小雨是p粉 : 回复@野生评述员:行为不对呀，哥们儿，她是酒驾呀，万一撞个人，或者自己撞桥墩儿上怎么办。难道卖个萌就能把错误掩盖了吗？
白面小七 : 评论还有说萌的，说什么又没闹事有什么好喷的，我去，这都尼玛什么三观，醉酒驾驶啊，敢情得让她撞死几个以后你们才能认识到事态的严重是不是？多少人命幸福家庭都毁在醉驾上面了，你们还没事儿人似的，就该让这群醉驾的都死干净，她不顾别人的生命，别人就也应该拿她命当儿戏
王文杰joe : 美颜相机的广告
一本正经的胡说_ : 长这样子，再用美颜相机能美到什么地步。
妹儿别怕哥是好人 : 要是是个中年大妈，估计评论又是另外一个风格了
妹儿别怕哥是好人 : 要是是个中年大妈，估计评论又是另外一个风格了
ES李美丽 : 没祸害到别人就算好的了！哎
MonKey云 : 这个逼装的我给满分！
拿一份爱给自己 : 回复@吃太多会睡不着:看这样，可能是q7,有人的，这点小事不算事
落雪尘华 : 真是喝多了。。。[笑cry]
追求无望的梦才最光荣 : @凡夫俗子苦乐多 [doge]
桑德兰咆哮_ : 感觉自己萌萌哒[笑cry]
我是cshigh : 这是醉驾，比酒驾还严重！
媞子酱 : 好可爱啊 但是下次别酒驾了
卡拉牧羊人 : 这都能洗地[笑cry][笑cry]
