-MineMing : 透视？
李-钱 : 抓去枪毙了
誰是李少 : 支哪女死。。
高冷美颜小果仁 : 男司机就是司机，女性司机就要带性别是吧？这舆论带得6[微笑]
阿喃啊c : @乌云乌云快走开啦啦
刘玖V : 请把女去了，难道你下次要打个男司机？
年轻的笑多了会怀孕 : 看了心痛
Zx_卓 : 小孩在停车场地上玩没人管？
狸狐狸狐小 : @liang伟婷要早睡
末未信名 : 开车可长点心吧！注意观察
0浪子花错0 : 希望这几个小孩平安。
踽行君 : 女人们呀！你们特么还是坐轿子吧！！[抓狂][抓狂][抓狂]
易楠囡 : 我的天啊吓死
噗嗤噗嗤咔 : 首先，在停车场本来就应该缓慢行驶，本来车里视线就有盲区司机还玩手机，其次，家长不应该让小孩在无人看管的情况下，在停车场玩耍，最后，一般小编会写肇事司机，可是强调肇事女司机，所以导致很多人比较敏感，也是小编的疏忽！希望三个小朋友早日康复[爱你]
饶丹丹ye : @洛洛的名单
树的草和猫 : 痛心！同时，希望车以后都装个感应器之类的，但愿有才之士能创造个更安全的交通工具
我不是不是耶和华 : @我是傅芸娜 开车千万不要再刷手机咯
滚你mabi : 说者无意，听者有心[微笑]
御前侍卫1228 : 这司机祸闯大了，看那小孩被车子压过感觉真难受
御前侍卫1228 : 这司机祸闯大了，看那小孩被车子压过感觉真难受
浮塔梦 : 回复@志清VIP:好好说话
怎么取名字最酷 : 小编坐进车里看看，能不能看到靠近地盘的东西，双方都有错！
朵朵er_于 : 太恐怖了。我的天啊，可怜的孩子，
陈大懒梦人 : 太吓人了吧
好像有十几枚饭 : 说句不好听的，男司机也碾死过很多人，有的还跑了
ACE_sunshinegirl : 让小孩在停车场愉快的玩耍吧。反正孩子都是捡来的。
彦蓁弟弟 : 玩手机的司机不对，让孩子在路中间玩的家长你去了哪里？小编，如果司机性别男，你会在报道上注明性别吗[喵喵]
MAYBEYOUARERIGHT耿耿 : 回复@薄荷味Superman:一棒子打死一群人
要么瘦瘦瘦要么丑 : @猴子的小鹿
vi-lyn靖靖靖 : 回复@-gj2016:就是你，你@ 我干嘛
won-and-only : 坐着玩，在车里看得到？
最少都要四个字 : 都男女平等了 司机还不能说是女的了？
一只迷妹邓BIUBIU : @周叉点
Rui睿丶 : @Daiyi鑫
丽丽酱在东京 : [吃惊][吃惊]太可怕了
Lion_meow : 司机有错但小孩坐在路中也太夸张
小王被占用 : 人家报道说的很明确目击者说的是女司机就事论事，好多具备正义感的人士一下就不乐意了搞得跟开车技术挺好是的～
蜜西倩 : 打车的时候遇到过，玩微信
一个冬冬一座城 : 女司机[微笑]强调司机性别对此次事故有任何意义吗？
今期彬彬补番忙 : 现在肇事司机不能提性别，尤其是女司机一定不能提，否则就是政治不正确！
风风语语 : 同时压到三个孩子，这个司机应该被终身监禁。
Dou13931 : 都有错
黎大和尚 : 回复@七喻:稳住稳住，有前雷达，有障碍物会响的，不过还是要注意啊
龚嘉玲 : 还坐停车场地下  家长呢？  视野盲区[doge]
风间青萝_214 : 不管男女，驾驶员有责任！父母责任同样有，停车场不是玩耍之地！
谁爱那谁 : 开车玩手机害人非浅……
CCL--_ : @稞稞玥玥_ @失控的大脸妹子 @miss--蜜 吓死宝宝了
永远爱蜜蜂的猪 : 这个必须转，现在拿着手机开车的“二把刀”忒多了
又又儿2015 : 停车场进闸口处是斜坡，这款车座椅比较低，司机一进闸就右转，三个小孩坐在地上肯定是处于盲区了，一手取卡一手握方向盘，不存在多一只手拿着手机看吧…据说这几个小孩家长在附近开店，几个小孩经常在停车场玩，我上次就看见有小孩蹲停车位上拉屎…管理处也说了多次提醒家长无效，这次真是买个教训了
cccccccccccccccs : …
不二mmb : 家长呢家长呢，太不负责任了，这怎么看孩子的，停车场能随便坐地上玩么？！！？
Z-馋喵-YH : 我就不明白了，开车玩什么手机？
吃饭睡觉养肉肉肉 : 家长固然有错。但是孩子是无辜的！！！！！！！！！！！！！！！！！！！
不爽也是爷 : 回复@干一人青_:那是玩的地方？父母尽到监护职责了吗？
超级vip10至尊用户 : 回复@DogeDoge111:断开了吧
嘉文十四zz : 回复@就叫Lili_feng吧:那你一定是直女癌 对吗
剑十五是阿宇啊 : 回复@薄荷味Superman:您看到过有专门提示说“男司机”的嘛？？？
LTYLYT : 各有责，主要是监护人的责任。
吃饭睡觉养肉肉肉 : 孩子的鞋。。。
闪闪发光的lynne : @齐彬888
李小事儿民 : 回复@龟龟桐:双方都有责任……恐怖啥……[汗]
南征北戰一個花 : 小编吃屎吧 女司机杀你全家了？有必要强调女司机？只要是犯了错 就是那个女人自身的问题 开车的人总有智障 和男女无关 滚吧你[拜拜][拜拜][拜拜]
剑十五是阿宇啊 : 回复@土豆土豆我是地瓜12346:说的太好了！！！说实话，现在孩子的很多毛病完全是家长教育不当弄出来的！
武辉武 : 干啥都得专心点
迷迷糊糊过狗生 : 我遛个狗车多的地方还看得很牢呢，这几个孩子家长去哪里了？
静心夜雨 : 真心恐怖
了不起的呆毛王 : 女司机成贬义词了？呵呵，女人们的集体自卑而已
甜甜豆花香 : 回复@胡小木stronger:其他都没有问题，但是孩子还真的不能在停车场玩～
已攻下鬼神大人专属19禁 : 看着好可怕
DogeDoge111 : 天啊，一个孩子的手粉碎性骨折了吧
Axm曼 : 天哪 揪着心看完的
鹤见七海 : 想知道这里是停车场还是一个街道，还有就是便利店门口为啥会有这么多车位，另外如果这里是车来车往的停车场，那这几个孩子在这里席地而坐，被撞到是不是和孩子与孩子家长有关呢？麻烦圣母狗们把事实看清再评论行吗，拉低智商。
孤独得凯凯 : @王饺子大仙 @小汤圆没有馅儿why @隔壁的二胖
taytaytay- : 天呐…把胳膊都压断了…
让白土司 : 万幸孩子没生命危险[吃惊]，太吓人了
剑十五是阿宇啊 : 1.盲区啊，玩不玩手机特么都看不到啊！！！ 2.为什么强调女司机？？？！男司机为什么从来不提？？？明显性别歧视！！！！作为国家主流媒体，请谨慎发表新闻言论！ 3.家长怎么教育孩子？？？呵呵哒，看看大街上随便牵着孩子就闯红灯的家长就知道了，这个种事怎么会在他们“教育”的范围。。。。[挖鼻]
老莫阿 : 司机当然主责，监护人次则也是应该的
叫我A-Li : 所以老是提走路不要低头看手机的时候也要提醒开车不要玩手机[doge]
熊贱贱才是机智小达人 : 一半一半吧，这仨孩儿也是把大街当自己家了，安全教育很匮乏！
李冠敏 : 先不论这件事，确实女司机问题很多，我就经常遇到，引起我注意的驾驶行为一般都是女的，不然怎么会有‘女司机’这个说法，没人会无缘无故针对她！
依梦晓寒 : 家长心比天大，我不要骂人，可怜孩子，但愿一切都好
Ryouta亚子 : @云呢拿味噶哈鲁吸
-gj2016 : 为什么小孩坐在地上？？
-gj2016 : @vi-lyn靖靖靖
张子薇- : @电灯0
薄荷味Superman : 评论里关注点在女司机上的那些人就是每次新闻一说谁贪污了它就会认为所有公务员都贪污的那种人……因为这就是它们的惯性思维[微笑]只不过这次说的女司机他们也是而已所以才不那么片面了[微笑]
Aleda_x : 回复@就是崔佳伟丶:嗯 睡吧[嘻嘻]
Windyyyyyyyy : 女司机招你惹你了？
终点站Nic : 小孩投错胎了才会跑那里去，祝他们好运
就是崔佳伟丶 : 回复@Aleda_x:车跟我的一样 老款 我会注意的
珠笑了 : 这这这！！！
十七年前l : 本来车前面就是盲区  小孩又坐在地上 所以车主可以说完全看不到   孩子的家长又在哪里 这么不负责任  任由小孩在停车场耍
潞仔很忙 : 可怜的孩子，一定要注意安全 但愿他们能有好的结果
大猛王 : 这个标题有点带节奏了
Islandsyy : 回复@志清VIP:性别歧视 你也是够了[微笑]
梧桐雨9607 : 开车就好好开车，随时随地拿个破手机。
三途川上奈何桥 : 卧槽好吓人
云儿Hai : 转发微博
云儿Hai : 转发微博
江师大范儿 : @中国矿业大学 南湖尚苑工地，天天半夜渣土车出动，噪音扰民，粉尘漫天扬起。有人管否？！[蜡烛][蜡烛][蜡烛]
小小小滢子x : 我就想知道孩子怎样了，
吴多娜 : @0藤条焖猪肉
曌翰 : 很多话都不知道该怎么去表达、一句话可悲
D先生怎么都吃不胖 : 回复@胡小木stronger:我没听清你再说一遍？停车场是孩子们可以坐在地上玩的？？
忔兮 : 我也是他们这么大的时候被车撞了。生日的时候大人带街上买吃的累了跟不上家长蹲马路边吃东西然后就一辆车开过来就把我压倒了。当时车胎一直压脚上那司机都不知道旁边很多人让他倒退他还往前开。还好年纪小恢复好就是脚踝永远一个疤。主要小孩蹲地上司机的视角看不见🙈还是得爹妈带好毕竟小哪里都乱跑
花沿_ : 要玩就算了，居然还坐地上，想跑都来不及[汗]
MCM喵5喵5小人兒2兒2海外代购 : @赛特利亚专属VIP韩游
薇薇安愛吃蛋糕 : 好可怕啊..
胡金旻是这个旻 : @暖暖暖暖暖暖男成长ing @小国子-
大眼睛的胖胖梦想记 : 回复@天蝎座腹黑女:千万别来让天蝎座抹黑，你的三观，开过车吗妹子。她玩不玩手机都看不到这三个小孩的。
夏天-吹暖气 : 那些说不让强调女司机的，一般都没开过车，到路上看看去。高速上占用快车道开个五六十码，路上一个车驾两个车道的还少吗？哈哈说不得了哈…
薄荷味Superman : 女人到底有多敏感看看评论就知道[哼]报道新闻总得交代新闻背景吧？那就直接说有人开车压过三个小孩？能不能别这么敏感！从一个事件中吸取教训有则改之无则加勉就行了非得每天上纲上线的圣母、
无限1q : 家长大部分责任吧
哒哒哒哒poppy开花 : 便利店门口这么多随便划的停车位才是问题所在吧？
天才就是打不倒 : 旁边一个便利店，周围全是停车位的线条，全部都可以停车，如果是便利店老板的孩子呢，他们的活动范围是有一定局限性的
ivaX- : @WuTianTian-
天肄 : 这么差劲的技术，连压三个小孩，你死定了！
_姚俊茹 : 回复@_像热烈:知道就好
_姚俊茹 : 回复@_像热烈:知道就好
silent_honor_Ark_Knight : 司机是碾人了，但是主道上为什么会凭空坐着三个小孩？
大眼睛的胖胖梦想记 : 今天才看到一个，一伙小孩在停车场跑来跑去，前面几个都过去了。最后的小女孩跑过去的时候离那个车只有不到一米。根本来不及。可能不是看手机，只是在盲区没有看到呢。
_像热烈 : 回复@_姚俊茹:再也不看手机了
ZC-_yooooooooo : 开车不要看手机，哪怕一秒都不可以@机械萌神
LixixiLyy : 有箭头，是通道，为什么孩子会在那里玩，家长在做什么？
像我这样可爱的美少女 : 天呐心疼[可怜]
丝羽美文 : 这3个哇坐在路中间干嘛
LSW168创始人 : 就算三个孩子没有坐在地上，手拉手走，也逃不过这样的司机。司机开车就要有责任意识，开车连车前有人都看不到还碾压，这样还开的什么车！@V胖机：草草草看完要死了，真的开车不能看手机不能低头！！！家长一定要告诉明白孩子停车场是干嘛的!
春风吹又生狗带 : 孩子玩的地方再不对 也不该认为司机眼瞎就是应该的 评论区都什么风气啊？！[怒]
Phoebe-e : 最边边的小孩伤得最重
就叫Lili_feng吧 : 报道请不要带性别歧视好吗？！男司机就不会碾人了吗？不要乱引导舆论导向！如果你是男的，绝对是个直男癌！
劉hxwill : @舒大耗子吃猫肉
风筝飞远了 : 回复@强922:不能全怪司机 这样一来司机也是受害者 因为小孩坐在地上车里根本看不到 盲区
JunB左 : 回复@考拉静:人家不过陈述事实，何必这么敏感
Aleda_x : @就是崔佳伟丶
风筝飞远了 : 没开过车的别乱说 都有错 但受罪的是小孩 那个地方是盲区 车里面根本看不到这么小的小孩还是坐在地上的 看不到啊 也没办法全部怪司机 最大责任是家长看护不当 但很不幸这是一个意外 [微笑]
KongxBoss : 诶不是评论里面怎么这么毁三观？凭什么怪司机？你他妈三个逼玩意坐在地上！司机是盲区ok！他看得到这么多？这三个逼玩意怎么没被压死过去
天蝎座腹黑女 : 这个女人。。。突然不知道用什么词来形容她。日妹的
yoursmine- : @mineyours-
四十大盗头头 : 这事不怪司机
大叔今年二十一 : 都会同情弱者，这个地方是熊孩子玩耍的地方吗？[怒]家长呢？难道不知道教育孩子该在哪可以玩那些地方不能玩？
清水寒木 : 小朋友在停车场玩？家长呢。
hey_請叫我Athena : CC
Wang珏1982 : 司机开车大意，家长监管失控，停车场无人监管，都有责任！
眼里都是泥 : 活该！现在太多家长不关心孩子！
lxy在线 : 周边那么多车父母也不管管！这只能是他们仨的命了[拜拜]！
小小的我43771 : 为什么孩子要在停车场玩儿？？！
淡定ED微笑 : 孩子在路中间玩耍就不对了。
FengYu_55 : 大部分人都是在意女司机 有人管过这三个孩子怎么了吗？
给我一礼拜的阳光 : 我的天[悲傷]
LINNA_小纳纳 : 再看一遍，司机绝对看手机了！小孩的父母呢？安全意识不用教吗！能随随便便坐停车场？
Ghild091 : 多危险的地方，在那玩！！！
土豆土豆我是地瓜12346 : 回复@胡小木stronger:孩子能在停车场玩？这是车流量很大的地方，说了是停车场不是游乐场，小孩绝对不允许在里面跑来跑去或者停留，还是在没有监护人在边上的情况下，做父母的应该给孩子灌输安全知识，哪里可以玩哪里不可以，停车场，湖边，家里的插座，就是因为你这样的思想，觉得小孩可以在任何地方玩才会出这么多安全事故
前排_94054 : 卧槽！碾压的车子还颠簸了一下！！！！看你妹的手机啊啊[怒骂][怒骂][怒骂]
错综复杂-LY : 卧槽，小孩子怎么在地上玩？？没人管吗？？！！
一只正直的陆婷推 : 熊孩子和他们的家长少说占一半责任，这个角度谁看得到[微笑][微笑]，这么低完全处于盲区的好么
苏某某和阿丹 : 女司机怎么了
苏某某和阿丹 : 女司机怎么了
琳老大82 : 好吓人
安娜当当 : 三条人命啊  死女人 开车没长眼睛吗  要是你的孩子你心里会作何感想
爱豆是大王喵 : 我前天过马路差点被撞翻，男司机在打电话，呵呵，这种错男女都犯，请一视同仁，不要动不动提人性别，怎么不见男司机出车祸的时候专门提一下人家的性别
暴走的Johnny : @我喺小矮仔喺我 CC
青衣妙音 : 真是万幸！孩子家长也有很大责任！
想做胖宣的英雄 : 搞得像男司机开车不玩手机似的[doge]非强调什么性别，小编吃屎
LINNA_小纳纳 : 天啊，或许是近距离司机没看到？但是小孩怎么可以坐在停车场呢？大人呢？安全意识大人不用教的吗！
少年何不笑 : 为什么要强调是女司机呢[doge]反正我也不是挑事儿的人，但我要是女司机我肯定忍不了
黑土风尚 : 手机真的害人害己
梁勇Super : 不能全怪家长   也不能全怪司机，不能绑架，司机有时候可能会出现视野盲点（当然不是这个），家长不好好看孩子，责任也不可逃脱，望悲剧不再上演，孩子健康平安[心]
叶韵歆之之助 : 好可怕
Maxlovecoco232 : 这个角度很有可能司机根本看不到孩子
撒哈拉_的沙 : 停车场里，小孩子坐在路中间玩儿，家长都不管管么，就算没有玩手机，车头前方也是盲区，很容易出事的，做家长的一点儿责任心都没有
在读书的大静 : 孩子好可怜
温莎776 : @你听那是我
dada王木木 : @yorick
kbjpamhs : 开车玩手机打电话是该明令禁止了
金誉梁闫 : 开车看手机者必亡
萍子Angel : [伤心][伤心][伤心]自己命不要的话，请别伤害别人，看的心碎
哈哈OK妹 : @liwei3770
努力努力再努力huna : 孩子看到车都不跑的？
葳葳_chou : 家长是死哪去了，好可怜的孩子，好痛啊、希望没有残废
低纬度的风 : 相信孩子如果是你的，一些人的评论就不会那么“理性”了[微笑]
切莉丨 : 这么智障的女人也有资格开车？
不如跳舞丿 : 愿这种事少一点发生
三叶草-Han : 为什么强调女司机？怎么知道是女司机又在玩手机的，换男司机也开过去了，那是盲区，最大的问题不是那三熊孩子没家长看管？搁哪个司机都看不到开过去了吧。这种事例有很多，家长没看着小孩就坐地上玩司机直接开过去了
完善5606 : 我今天也看到一女司机，一边开一边看手机发信息聊天
走过繁华的发展 : 回复@强922:有一种人啊开车时就会感觉是在坐车，以坐车的心态来驾驶车！这是极其危险的！就这次事件来说，能说女司机没有责任吗？
SWAGB_ : @Joy林啾一 @BIBIBABIBOBII_
