田生先 : 男司机的时候也有强调“肇事男司机”好吧，是你们太过敏感，总在里面找“女”字[鄙视]
从_你的全世界路过 : 干嘛要强调女司机，说实话，女司机出事故的概率真不高，只是偶尔，就因为你们这些人一直刻意强调，大部分的大小事故都是男司机好不好。
我只是想当学霸而已 : @米仔wu 你自己看看，是不是看手机
爱金毛丶爱生活 : 回复@习-李新政China:特么你刚学车的时候就开好了？？？？不也是有事没事开着车瞎晃荡才练熟的？？？
黄星颖哇 : 回复@韦俏一呀:玩手机[笑cry]
morning佳 : 司机玩手机固然是不对的，但请问是谁家的孩子，居然让孩子们在公路上玩！
爱豆是大王喵 : 媒体们只要女司机出个车祸就立马带上性别说话，导致大家都觉得女司机成杀手了，殊不知明明男司机开车猛而急出车祸的比女的多多了，但是新闻里却不提人家性别，误导大众制造舆论，这个世界就是什么受欺负的事带个女字看官们就津津乐道了
七戒的小窝 : 女司机 请远离我
ATTENTION小宝宝 : 果然又是→女！司！机！[doge][doge][拜拜][拜拜]
ATTENTION小宝宝 : 果然又是→女！司！机！[doge][doge][拜拜][拜拜]
Camlady : 回复@MAYBEYOUARERIGHT耿耿:你有病吗，是男的就男的，是女的就女的，这也要拿来说一下
FlorenceYuet : 我觉得孩子家长也有责任啊 谁会让孩子在这种地方坐下来玩啊
花花世界甜兔兔 : 小孩为什么坐在路上！家长怎么教的呢？
别吃朋友_抵制熊胆 : 回复@胡小木stronger:你没开过车么亲
不靠谱姺泩 : 孩子家长呢？就这么大方的放在停车场让坐在地上玩？为什么自己的孩子让其他人来帮忙监督照顾？说实话，鬼会想到在停车场地上会坐三个熊孩子[微笑][微笑]
别吃朋友_抵制熊胆 : 明明是家长的责任，停车场小孩坐路中间，是故意碰瓷吗
NNNNikimm- : 双方都有责任
观赏惊险人生 : 回复@cherrycherryboom:还是要多观察
林司诚 : [拜拜][拜拜]只要不會開車的都是女司機！就男司機會開車呢[微笑]
啨緒-莋怪 : 这个时候还管男女，这种人真欠死！
Victoria亚亚亚亚 : 他拐过去的位置正好是盲区，你懂么？仨孩子就在路中间玩 这合适么？这家长怎么不把孩子带到高速公路中间去啊？还女司机。。女司机怎么了？女司机该死啊？？？？性别歧视，也没见几个男司机把车开好了！！！
张帅zs1994 : 女司机真的可怕。昨晚碰到一个女的边开边玩手机。看到我和我朋友。还一个加速冲过来。差点没被吓死。
-廖雯- : 呵呵，孩子在哪里玩也不对
古德奈-少年 : 视觉盲区啊！ 根本看不见小孩！
乌拉乌拉-拉 : 祈祷孩子平安
习-李新政China : 女司机你不会开车就别上路，尤其是那些没长眼睛的，赶紧回家吧！在路上最烦碰到女司机，开不熟练别再路上瞎晃荡！
潘_婷Zing : 看见车过来，那几个孩子不会躲？那个司机开得不快吧[微笑]
孤热韩 : 人家没强调女司机，本来就是看手机压过仨小孩 就是个女的啊咋了？
1234567de8 : 女司机？？写这文章的什么意思？为什么前面加个女字，请作出解释！孩子家长呢？？？怎么教的？？？全是司机责任？？？不合理，那是行车道，家长孩子有很大责任！！！
爱豆是大王喵 : 回复@By-memory:肯定司机的责任更大一点，我没说司机没责任啊，问题是能不能动不动就强调人的性别，没见男司机出事的时候新闻专门强调性别的啊
酱爆肉62695 : 有的家长挺奇葩的，他们孩子就像放养的似的。熊孩子不是孩子熊，是家长熊，不用心管束孩子的结果就是孩子野性十足，可以随地坐着，哪里都是他的娱乐场所，每天四处跑。你们不要说这是孩子的天性，这样的孩子上学肯定不招老师待见。因为太野了，散漫惯了，不服管束，而且通常胆大不怕骂。
陈小新M : 仨小孩坐的地方是盲区吧
A_nell : 回复@wu妖王阿尔萨斯:骂的就是你这种歧视女性的人，女的车祸率高，男的车祸致死率就不高？
不抠耳朵会死星人 : 回复@LYWLLLLLLL:真能闹，难道路况也不要看看吗，你的意思是不怪司机喽
不是汉子的汉子姑娘 : 永远做不到平等，更何况男女平等，女司机不是司机吗？男司机开车不会出现事故？
明宇欧尼酱 : [doge]为何强调女司机？一直以来出事最多的不还是男的吗女司机怎么了性别歧视吗女司机就马路杀手？？？
明宇欧尼酱 : [doge]为何强调女司机？一直以来出事最多的不还是男的吗女司机怎么了性别歧视吗女司机就马路杀手？？？
蔓难图 : 请问家长在哪里？
刘先森家的乖宝宝 : 舆论就是被这么带起来的，这个事情还在调查你们竟然得出结论了呵呵呵
小天天棒棒哒 : 小编为什么要强调性别呢？大概是因为强调女司机的新闻总是能获得更多点击率，如果这个新闻只是写成“司机”也许不会引起这么大反响——男司机出车祸太日常了，已经不是新闻了？
爱我中华0629 : 看看下面的评论，漠视生命的脑残智障者比比皆是，有你们悔之莫及的那一刻！多积德行善，否者会遭天遣的！
果仁1234 : 转发微博
我是太贫但不是公主 : 心疼小孩，但是，这是盲区，无关手机，为什么就没人谴责家长，让孩子马路中间玩耍应该么？
其实我还好-hl : 为什么总是强调女司机，遇到女司机出事，每次都会着重强调，然后很多人都会对女司机有偏见………
OAOA瑞 : 双方都有错
小新家的女主人 : @小新也忧伤 停车场管理员 孩子家长 都有责任！！！！
Hz99706 : 回复@剑十五是阿宇啊:是男是女为什么不能说？说出来就是歧视这种想法才是真的歧视，女的凭什么有特权？不能说？盲区啊？开过车？
行者无疆善了个哉 : 孩子懂什么！司机家长一半一半。不过我还是觉得司机责任更大
加Eee : 这么压还能脱离生命危险 祝好（听说男司机开车看手机就不会撞到人呢[微笑]
靖靖君君 : 家长死哪去了？？？死了吗？？
Hz的张小鬼 : @澎湃先生
嘴角牵起的弧度 : 回复@MAYBEYOUARERIGHT耿耿:调查结果就是女的在开的……小编不是乱说的
wu妖王阿尔萨斯 : 回复@A_nell:数据表明女性司机车祸的发生率比男性司机高好多，还有你这种一上来就骂人的，素质真是差到了极点
米斯鲍 : 回复@妹纸我不吃番茄酱了:好像是cc[偷笑]
嘴角牵起的弧度 : 回复@剑十五是阿宇啊:调查结果是女的在开车没错
YuLiangChen_ : cc底盘这么低压下去还能活？
韦俏一呀 : @黄星颖哇 感觉手都碾碎了！
獾贼 : 回复@DogeDoge111:都成泥了
我阻止自己焦急的呼唤你 : 为什么小孩在路中间玩[晕]珍爱生命啊
莪的名字就是比你长怎么了 : 为什么总是要强调女司机！
Mrs衫妮小姐 : 1首先这是盲区。有可能不玩手机也会出这事（并不非赞同开车玩手机）  2小编为何要强调是女性司机？性歧视？   3小孩子在停车场玩就正确了？父母监护人在哪呢？ 4愿孩子早起康复   5各有各的不是。不要一并推给该司机
Monmo1995 : 谁也别说谁了，孩子没事都好说，家长们都干啥呢？
遂员 : @钦cc丶
刘恺威刘蜀黍宋宋仲基 : 这也不是别人司机的错好吗 马路上全是车那些孩子瞎了么家长也是无语
LYWLLLLLLL : 回复@不抠耳朵会死星人:你真正开车多了你就知道了。而且视频中人家不是刚起步是行驶中。行驶中怎么看？开一步下车看一眼？
悦然见南山 : 我昨天特地感受了一下，还真不是盲区，右转弯出去，地上有什么都可以看的一清二楚的，除非是她自己开小差没有注意看。家长也是要负责任，不应该让小孩到停车场玩耍。还好，脱离微信了，希望引起广大车主和家长的注意
Von_YL : @你强蔃 吓死人了！！
Von_YL : 好可怕[惊恐]
角雕松鼠嘿嘿嘿 : 小孩子往那一蹲真的是盲区，完全看不见
妹纸我不吃番茄酱了 : @米斯鲍
郑斐Alex : 其实大家可以去做个实验，小孩那个位置蹲着的高度，司机可能是看不见的。不过司机压了人肯定有感觉，怎么不停就有点奇怪了
-羊狗 : 回复@志清VIP:大哥你有病？男司机就不出事故了？
囧鱼头009 : 跑停车场玩，这家长心太大了
薄荷味儿的Superman : 评论里智商感人、感觉都是小学毕业的世界观角度
Noollrn : 回复@胡小木stronger:孩子在停车场这样坐着玩就对了？？
Mrepublic : 回复@aLExiS_Ji:为什么小孩坐那啊
sky小简安 : 我关心的是，小孩子为什么在那里玩？？？？
睿锶菱 : 别特么一出事就女司机，小编你妈不是女的吗[怒骂][怒骂]
鹿M鹿-F7 : @寳儿佳 诶我天！！
Summer-afternoons : 我想双方都有问题，司机是不应该玩手机，但是孩子父母也没教育好这个地方明显不是玩的地方
2015粉 : 小孩没事就好 司机该反省一下了 这可是生命
闭起双眼你在我心底 : 回复@一只正直的陆婷推:盲区？？我开车的时候前方有什么东西都看得一清二楚，这个明显是司机没集中注意力，更何况三个小孩都没看到这是眼睛瞎了吗？？
第四叶80072 : 回复@爱我中华0629:脑子有屎是嘛，这什么思想啊
渺小的宇宙无尽的探索 : 说盲区的脑子没问题吧？你开出车吗？你以为是倒车吗 还盲区
醉了叻 : 这都压不死[doge]
火马小火龙 : 什么叫女司机就是马路杀手 我妈十年驾龄 只有被追尾过三次[微笑]还有孩子也请像手机一样带在身边
蘑不成一个菇 : 停车场 孩子这么坐着 本身就是视觉盲区啊
我本如旧 : 开车玩手机现在是通病，我一个同事开车还看视频，真是够智障的
徐1991_71156 : 孩子生性贪玩，而且安全意识也没有那么高，所以希望平安无事[围观]
不抠耳朵会死星人 : 刚考完驾照，有人说是司机的责任，有人说是家长的责任！给你们分析一下，确实是盲区，但是！但是！科三考试第一项！环绕车体一周，观察是否有障碍物！这你都没看！你还敢说这不是司机的责任！事情都发生了！你这些个家长也逃不了关系！但是！事情发生了，想必是孩子家长更伤心吧！
海伦帆勒 : 回复@爱我中华0629:提性别有意思吗？男的就从来不出车祸？
我生病了1234 : 车子开的很慢了，孩子看到车子来都不让一下的，活该被撞，人就应该在自己该出现的地方出现，可怜之人必有可恨之处
闭起双眼你在我心底 : 回复@剑十五是阿宇啊:你确定这个位置是盲区？？？
小尾巴-a : @毕文剑Kumbaya
就叫微醺 : 家长的责任也不小 马路中间是玩耍的地方吗？
数字迷宫木榔头233 : 盲区？
超超heli : 妈妈要哭死了
澳小丫减肥记 : 看好自己的孩子吧，也别总怪人家司机，大人都是干什么吃的，出了事哭天喊地的
Anderlye : 卧槽！这么吓人
于哆哆的猫 : 回复@胡小木stronger:不是说司机没责任，但是停车场不是给孩子玩的地方。当然不能，还坐那玩。你是不是经常带你孩子在停车场玩啊
conanhaozhang : 回复@怪__圈:是不是女的，是事后调查的，不是视频里看出来的
吴梓佑HB : 回复@惹阑珊:好多次想@ 你 但是一直忘记你的名字
A_nell : 回复@wu妖王阿尔萨斯:你他妈有病吧，强调性别有意义吗，男的就不出车祸？
520728LIAO做最好的自己 : 熊孩子的家长哪？为什么强调性别？这个角度，这么低难道不是处于盲区？
嘎嘎嘎露露 : 回复@爱我中华0629:把你阉了
嘿这是你丢的小西瓜么 : 以后车身360度安满摄像头，没人了再开车好不好？[微笑][微笑][微笑]管他视觉盲区不盲区对吧[微笑][微笑]
CJTSIA : 回复@嗡嗡的老翁:明显不是司机的责任好吧，你没开过车也坐过副驾吧，这种盲区根本看不到，而且这是停车场谁放小孩子坐在停车场玩这么不负责任？
婧如妹子_ : 只能说双方都有责任，但是个人认为监护人的责任更大！家长要管住自己的孩子，孩子怎么可以在车这么多的停车场坐地上玩呢！司机应该在行驶过程中不能玩手机！
JANGYANHUI : 太恐怖了，家长要看好自己的小孩开车也要多注意呀，多疼呀。
_RuAn妹儿 : 卧槽[泪]
_RuAn妹儿 : 卧槽[泪]
那么久-- : 谁让孩子坐停车场玩的，爸妈都不在附近看着么。
虫宝宝krisyeolove : 为何要强调女司机？而且这是孩子应该玩的地方？家长在干什么？何况有可能是司机没看到有孩子坐在地上玩？
Rainmaker168 : 哇靠..停车场耶..谁会想到3个小孩坐地上玩...最应该追究责任的是3个小孩父母....
奔驰小毛驴 : 这明显司机的责任。家长，谁有空时时刻刻在，总有疏忽的时候。你怎么不知道，父母正在找跑出来玩的熊孩子
NeverMoreLuna : 在停车场坐地上玩 本来就危险 家长怎么教育的
我很乖又很高 : 何必故意强调女司机？为了增加舆论效果？为了误导大众观念？  那些不平等观念真的够了。
Hathawayq_o : 谁让他们在这玩的 反正都有错
欣怡菇 : 回复@小邪的思念:🙀🙀🙀
好像有十几枚饭 : 回复@这是一口煎蛋的小情锅:那这句话说出来好听？我只是针对那些将矛头指向女司机的同志们的无理评论，来句反方向论证罢了。
今期彬彬补番忙 : 回复@马建国的暖宝宝:原文也就提了一下“女司机”就让你受不了了。那这么多车祸中提到“司机”就默认指代了男司机。那男司机们是不是得冤得跳楼？
因为我傻呀所以我傻呀 : 父母没有看护好自己的孩子 结果足以让他们付出太沉痛的代价了 可怜了孩子
村口九美子 : 可怕
小邪的思念 : 好可怕@欣怡菇
Axy0519 : @蝶舞花飞47774
蘑菇少女723 : 回复@胡小木stronger:不能，停车场不是孩子玩的地方，不明白去百度停车场是干嘛的，游乐场是干嘛的，孩子遇到这样的家长也是受苦了。还有，汽车有盲区，有时候真的看不见。祈祷这几个孩子平安！
chuchu-LB : @Child_小八
我想要你陈伟霆 : 天哪
阿弥rr : 难道不是视觉盲区吗 孩子坐的那么矮 怎么会看得到呢 停车场怎么是玩耍的地方 如果不是因为看手机而造成事故 媒体要为自己误导舆论负责 ‘疑似’ 只要不是确定就别妄下猜测给别人带来困扰
吃葡萄不吐葡萄皮Ycn : 回复@胡小木stronger:你厉害 孩子是可怜 我是俩孩子的妈妈我也看着心好痛。可是孩子可以在停车场玩吗[汗]看过太多孩子因为身形小站在停着的车前没被司机发现而碾过去的 所以我从来不让我的孩子靠近别人的车，所以停车场车来车往，有时候地下停车场还光线暗 我觉得不可以让他们在这个地方玩，开车真的不要玩手机害自己害别人
无暇四顾002 : 回复@权太极的傲娇受:我是不是中国人不重要 作为地球人都应该遵守法则和道德 懂得真善美
薛奶子 : 孩子就在哪里坐着玩 而且还是过道
宠溺882 : 司机和家长都有责任
明亮姑娘30228 : 小孩父母呢？坐停车场玩，这不是找死吗？平时教育没做好
vae悲画扇 : 小朋友坐的地方是盲区， 不管有没有玩手机 不管是男司机还是女司机  三个小孩坐得那里  怎么可能会不被撞到   家长的责任要多一点  为什么要让小孩子停车场玩儿  停车场的保安呢 也有些责任好不好 看到小孩就应该疏散   还希望公平公正的对待这些事情 也希望小朋友早日康复
大怪兽怪怪的 : 话虽说这几个孩子坐的位置，在车里看属于盲区，但是你正常不管从左或者右走过来开车应该都会看见这几个孩子坐在那儿吧？我就不说考驾照时要求的上车前环视车周了。
我爱养生0213 : 回复@爱我中华0629:蛇精病啊
发芽_开花_结果 : 回复@胡小木stronger:就是嘛！就事论事，发生这样的事本来就要多提醒小孩不要到车多的地方去玩，我这话有错，涉及人身了？
summer躲在冬天的角落里 : [祈祷]
独树一蕉 : 父母没责任？作为监护人是怎么履行职责的？
做梦都在旅游嘤嘤嘤 : 这几个孩子的家长呢？司机责任肯定有，但为什么孩子会坐在停车场上？？？这种父母也有责任好么？！
sonothingserious : 男司机出事的时候从来不提性别 你这么双标你妈知道吗？
海笑乛v乛 : 这仨小孩不要命啊[汗]
机智帅气学长 : 这些小孩的父母看到这画面想杀人的心都有吧[怒][怒][怒][怒][怒]
wuli亲故哩 : 想问孩子的父母呢，放任他们去停车场玩真的好吗，并且还强调了女司机，这不是故意的吗，那以后女的是不是要被限行了
机智帅气学长 : 我只想骂人，操你妈的，你开的是车吗？你开的是杀人机器[怒骂][怒骂][怒骂]
d啦n梦 : 为什么小孩会蹲在那个位置玩耍？
Christine的生活日志 : [祈祷]🏻[祈祷]🏻[祈祷]🏻[祈祷]🏻[祈祷]🏻[祈祷]🏻
胡小木stronger : 回复@一只正直的陆婷推:上车前不应该观察车况及周围环境么，交法明确写的。简单讲，车底有人或者有猫狗乘凉怎么办。当然在国内压死猫狗最多赔点钱，国外似乎一样有法律责任的。
Magicman_L : 说盲区的是智障吗？你特么停车停这个样子？
婷姐姐定制手机壳and银饰 : 我看到手断了[衰]
白月菊 : 三个小孩的家长是死人吗
又鲸 : 司机错误严重，但请不要故意强调是女司机，好像男司机从来没出过事故似的。出了这样的事，家长也难辞其咎，停车场来往车辆不断的就放任孩子坐在地上玩，谁也别怨谁[晕]
夜晚屋顶会飞的贼vv : 现在人是有女歧妄想症吧 说女司机怎么了？就是女司机啊还不让说了？这就是女性歧视了？女权癌真可怕
可爱冬傻傻哒 : 好可怕
你听那是我 : 回复@温莎776:盲区危险啊
妈妈的吻abc : 手是不是段了[衰][衰]
古骁骁 : 屌癌 你丫从你爸屁眼儿里拉出来的？
虾米是个小太阳 : 都有错吧，双方都该警醒
小双星的礼拜天 : 这是盲区啊 坐在里面 那么近根本看不到啊 我的天 和手机有什么关系啊啊啊啊 停车场 小孩就可以席地而坐了？
胡小木stronger : 回复@发芽_开花_结果:就事论事而已。你这样涉及人身，当心没发芽就居委了！
菑菅 : 动不动就中国人怎么样怎么样的智障，你特么不是中国人？部分中国人能代表全部中国人吗，是不是傻。[微笑]
CO妞来自火星 : 气愤！女司机怎么了？这么矮在视野盲区不是吗？孩子的监护人凭什么让孩子坐在停车场的地上玩！
花儿朵朵love123 : 回复@切莉丨:你没开过车嘛？小孩蹲下来正好是盲区 况且车速并不快。孩子家长和司机双方都有责任。不能只怪司机。
By-memory : 回复@爱豆是大王喵:其实这是停车场，小孩本不应该在那玩耍，大人的监护也没有到位。双方都有责任吧
菑菅 : 有人说“女人走路都走不稳还能开车上路？”哈哈哈我就想问一下你妈走路稳吗[微笑]
用户5766254962 : 有些人明明开车技术不好，还不好好开，玩手机打电话，作死一样！
今期彬彬补番忙 : 回复@per67009:什么都不说，没头没脑来一句教训人。你这才要多读书吧？
secret的日妆草原 : 热评里有个问难道小孩不能在停车场玩？[吃惊]难道小孩可以在停车场玩吗？车来车往很危险啊
JMxxxxxxxxxxxxxx : [微笑]你咋知道是女司机[微笑]你咋知道在玩手机[微笑]仨孩子坐路中间玩[微笑]家长不管出事了就赖司机，哦还是女司机[微笑]这是我看到对女性的最大的侮辱[微笑]
黄油小姐de代购屋 : 没有人会出停车场的时候看手机吧……应该盲区没看到
张激凸- : 男司机就没出过这种事咯？ 说句不好听 下次男司机出事请强调 “男司机[爱你]”
逐林随风向月 : 这个时候就别在说什么女司机不女司机的了，重点是看手机压到人了好吗？这事解决了再说女司机的问题好吗？看手机的司机我见过真的不少，手机有那么好玩吗，好玩到你藐视生命？请为自己负责为家人负责为对方负责为对方家人负责为交通负责，为社会负责。
我爱种花家CN : 家长不负责任，司机瞎
开心的向日葵wyy : 我姐姐也是经常开车打电话接电话，也不用蓝牙，怎么说都说不听，真是受不了！
译林逸林 : 我站司机[微笑]
