奥特曼夫人597 : 回复@妮1103子:棒棒哒
奥特曼夫人597 : 回复@Beeestyuhuai:没找着
巴啦啦能量小魔仙变变变 : 666
哭爹喊娘叫zj : 犯规不好，但是能参加比赛就是一种荣誉啊！
小宇的宇宙世界 : 无论什么结果，都是国家的骄傲[鼓掌]
冷颜_June : 全都是中国的骄傲。谢谢有你们，为祖国争光
Elaine_HuD : 棒棒棒！
Renaissance_華 : 回复@北斗_J:[鲜花][鲜花]
四十五度天使 : 中国加油，运动员都很棒
W最遥远的地方 : 可惜了
没安全感的张二疯 : 游泳本来就不是中国的强项，团体比赛犯规也是经常出现的事，其实没什么，每个去参加奥运会的运动员都是最棒的[威武][威武][威武]
AL墨亦白 : 赞我中华[爱你][爱你][爱你]
林宇珊珊111 : 真的是一发不可收拾了[笑cry]
北斗_J : 回复@Renaissance_華:我知道是犯规了，但其实就算不犯规小组第七也进不了决赛，媒体打出“犯规无缘决赛”的标题误导公众以为是因为犯规才没进决赛，增添不必要的指责。每个运动员都很棒，他们都尽力了[心]
Corrupt____ : #连云港核废料抗议# 很多外地朋友不知道发生了什么是因为连云港要建核废料处理站,全球性污染伤害整个国家子孙后代,今晚整个游行都已经有政府暴力镇压了,希望外地朋友能转发,媒体已经扩散不了全被封锁消息了~不管好与不好警察集体打人是真的~拿枪威胁也是真的~希望大家赞我上热搜让所有人都知道，赞我！
Zenyutyee : 我老公的个人赛还没开始呢
因为他有皇冠i : 全体赛本来就不是他们的强项  个人赛 还没开始呢 加油[加油机]️
王小旎-要fighting : 一夜赶超他国[心]前面的只是在开玩笑 正经的儿要来了哈
Z一Joanna : 没事，很厉害了。。宁泽涛，我这个小迷妹看你后面夺冠哦。
泽泽ingyu : 中国终于在澳大利亚上面了，狠狠的出了口气
筱冰芊芊 : 没犯规也进不了决赛啊……小组第七。别误导了，无论如何都是我们的骄傲[爱你]
PANGHUENG : 中国加油！
妮1103子 : 回复@奥特曼夫人597:不过成绩还是排名小组第七
Y-蔚娇儿 : [爱你]
-蓝蓝蓝蓝蓝蓝 : 回复@孤单北鸟:我是说澳大利亚队……
埃维森冒险日记 : 看成金龙泉[眼泪] 表揍我
ka乐乐2012 : 踩扁澳洲毛贼
_旧时光它是个美人 : 虽然犯规成绩无效挺可惜的，但就算不犯规这成绩也进不了决赛[眼泪]
Renaissance_華 : 犯规了！微博话题里有分析的@阳光younguang 这个po主上传的分析视频[太阳]
Renaissance_華 : 回复@北斗_J:其实犯规了。第一棒还没碰壁，第二棒就提早下水了。
盛夏的阳光好闪 : 回复@ayilan-:该滚的是你死废柴[弱][怒]
Beeestyuhuai : 回复@奥特曼夫人597:有的  好像在微博看的
喜欢着小鲜肉的另一个我 : @张抽抽和南花花 中国加油！！！[中国] [中国] [中国] [中国]
我想我应该换微博名了sss : 中国是最牛逼的
红燕捏 : 犯规？？？？
奥特曼夫人597 : 回复@Beeestyuhuai:心酸 连视频都没有了
奥特曼夫人597 : 回复@妮1103子:可惜了
崔雅琨就是ACE : 我涛[泪][泪][泪]
开户雨季 : 中国[中国][good][good][good][good]@未来yyt 
自从认识你我听情歌会哭 : 没有犯规的话也进不了啊。
Beeestyuhuai : 回复@奥特曼夫人597:抢跳了[哼]
Beeestyuhuai : 中国去年奖牌榜也是前半时间比较盛啊！后来被美国追上了，美国优势项目在后面，希望该拿的金牌都拿到手吧，毕竟少拿一个就少一个。
hijiayi : 没关系  我们中国人是创造奇迹的民族   我们会给世界一个惊喜的
笑笑要减肥 : 游泳队今年像中毒一样
阿狸的小呆毛 : 巴西风水不好，毕竟被殖民那么久，人奴性太强[挖鼻]
萌猪潇潇潇潇潇 : @静子大王的臭猫要拿她手机刷微博
你赔我瓜子 : 没犯规也进不了决赛 没事儿[doge]
妮1103子 : 回复@奥特曼夫人597:第二棒在第一棒还未真正到达时，提前起跳
DeDeDe蝶蝶- : 中国昨天还是排名第11名，泰国都在中国前面，今天就第一去了，外国人肯定一脸懵[眼泪][眼泪]
北斗_J : 没犯规也进不了决赛，不要误导了
梧桐艾草山梨-_- : [good][给力][给力][给力]
纠阖 : 游泳接力小组第七本来也无缘决赛，不要把锅扔给队友
douBle蔚 : 继续努力加油[心][心]
媛囍 : 接力没犯规也进不了[笑cry]排名落后
小王子7号少年 : 回复@Mosquito-ooo:不用明白，煞风景
不遇人渣_怎獲真愛 : 龙清泉，任然记得他第一次夺金牌的时候，那个笑容很阳光，祝贺他又揽一金
小纠结suk : 无论怎样，他们都是最棒的，我是所有中国运动员的迷妹[爱你][爱你][爱你]
奥特曼夫人597 : 有谁告诉我为什么犯规
孤单北鸟 : 回复@ayilan-:你脑子有病[愤怒][愤怒][愤怒]
星空下jason的追梦少年 : 为啥犯规
黑猫不睡4pm : 中国：承让承让[作揖]接下来的塞项还请赐教[作揖]
Mosquito-ooo : 回复@小王子7号少年:为什么好多人骂他，我没明白[眼泪]
一只国民宝宝 : 都很棒[心]都是中国的骄傲[心]
死鱼子Y : 中国爸爸不想理你并向你展示了他的8块奖牌
锦瑟伤别离_2324 : 感动，都是中国的骄傲！
wasqq123 : 中国的骄傲，好样的。
饭桶猪- : ...是不是巴西这地方风水不好..
i袁叔 : 牛逼   都说过了   我们打的是后期
小王子7号少年 : 回复@ayilan-:你要看医生去了！
Aanmply : 还是很心痛被取消资格
青瓷pot : 不要再说无缘决赛了！不要再说无缘决赛了！本来也进不了决赛，这样说太容易误导观众了，每一位运动员都值得我们尊重
Hjdnsjswydcb : 喜欢他们嘴角向下的样子，稳重严肃
TaeAl镜_204 : 这个排名，爽！
花名和你我喜你 : 中国[中国]的骄傲[心]揽金模式开始！哈哈哈[心]
yrwang- : [心]祖国的骄傲
蔚然曲- : 哈哈哈哈，我就说他们嘚瑟超不过三天吧[微笑][微笑] 中国已经解除封印了，等着一红到底吧[微笑][微笑]
拥抱月亮的火光 : 讲真，搜一下中国游泳队，发现2012之前大奖很少，孙杨，叶诗文，宁泽涛等等不断崛起，给了大众中国游泳很强的感觉，其实还是有很大的进步空间。
BomBati啊 : 中国最棒我爱中国 你们都是我们的骄傲
圈内御姐 : 回复@ayilan-:儿子，对不起，没好好管教你。
你的唇红烈焰 : 能站上奥运会赛场的人都是我们的英雄[心]
圈内御姐 : 回复@ayilan-:滚你姐姐的b里去
一路斑驳未归言 : 回复@诗诗肖:游泳馆和中国爸爸犯冲[笑cry][笑cry][笑cry]
俞萍y : 中国队永远是最棒的。
小zie泽 : 回复@ayilan-:你他妈有病啊？
钰晴是乐橙呀i : 无论什么结果，他们都是国家的骄傲。[鲜花][鲜花][中国]
Chrysanthe-mum : 回复@ayilan-:你有毛病？
诗诗肖 : 游泳队今年运气不怎么样啊[泪]
勋熏熏熏熏 : 中国队加油
想当小太阳的Endi : 无论怎样都是最棒的
Xuang_fei : 都是好样的！
翔颖永爱 : 太棒了！不论冠军，亚军还是季军！都是中国的骄傲！我们的骄傲
高欣悦- : @唐晓晶晶亮Crystal 图3像奶妈不[嘘][嘘]
蓝色星海_希 : 别太自责，继续加油#中国游泳梦之队#
缠绕在指尖的糖10069 : 龙清泉的比赛直播我全程观看，他不断突破自我，这种精神真得很棒！他虽然个子矮小，但实力的确超强，时隔8年重回世界之巅。[good][good]
荔枝中秋要看捉迷藏 : 借用某网友的话，林永庆犯规抢跳，但是希望大家客观对待，这本来就不是我们优势项目，即使成绩不取消小组第七也进不了决赛。林永庆也是非常优秀的运动员，希望大家别给他压力责备他过多
圈内御姐 : 恭喜冠军们！
