冷韩09802 : 很想交朋友，你们在吗
灬颜08127 : 对
弘毅--刘冰 : [蜡烛][蜡烛][蜡烛]
南审荻思文学社 : 九一八，南京听到的警报格外的响，大屠杀的耻辱还依稀在街上回晃。 勿忘国耻，勿忘南京300000同胞的鲜血和绝望、哭泣……
新神月 : 转发微博
Leobros : 一
山山水水-ok : ！[蜡烛]
灯火阑珊处91307 : 一个韩国偶巴随便发一条微博，一天内赞过十万，评论两三万，还不是最多的时候呢。这说明了什么？看来和国家比起来还是偶巴亲？哀哉
她说她叫馬小欢 : @我可以代替你所有的灯
懒懒的筱媣 : 唯祖国与信仰不可辜负！勿忘国耻！（原谅我的时差！）
氓氓sweet : 不会忘记
威猛的琪哥哥 : 大家都真的好好爱我们的国家吧
YT-kkw : 转发微博
Ren-逍遥哥 : 历史不容遗忘…[hold住]
黑夜的白眼 : 勿忘国耻！！！
全国火车票代购 : 我来看看
全国火车票代购 : 我就看看
我的球衣是三号 : 我永远不会忘！
mscurry : 勿忘国耻
李奇斌老师 : 记得……不忘
团团是个大馋猫 : 回复@sarahly871:请问你说的国家是中华大地上五十六个民族还是目前的执政党
郑传军14457 : 中国人历史上曾经有过多少次耻辱，还不是好了伤疤忘了痛
团团是个大馋猫 : 可笑掩耳盗铃
喜欢D大C : 爱我中华时刻记得国耻
叶狠美 : 相当给力哈
谜一样的星辰 : 勿忘国耻，更需警惕内患。一个强大的中华民族一定要先把国内的素质提高上去，把国内的蛀虫消灭干净
石音512 : 勿忘国殇，吾辈自强！
五岁那年养过狗 : 永远在心中
Sudoudou颖宝 : 勿忘国耻、对了那些喷子狗怎么不出来说话了
嘟嘟Q糖 : 庄严而肃穆的笛声在高空回响，哀怨惆怅让人无法忘记[蜡烛][蜡烛]
如你所愿对瓜 : 转发微博
艺人王祖贤 : 回复@HLY稻草人:你没钱去
仲夏Michelle : 铭记历史，吾辈自强！[蜡烛][蜡烛][蜡烛]
诗骑白马来 : 转发微博
水可载舟一可赛艇 : 回复@蛋卷怪和吐司超人ar:[害羞]
朵多新星之时间停了 : 铭记历史 @麦本本笔记本: 勿忘国殇，吾辈自强！
笑敬过往的妞 : [悲伤]唉[闭眼]
厦门174全国后援会 : 回复@雷雷雷的地盘:哈哈哈哈厉害了我的哥[赞][doge][哈哈][哈哈][哈哈]
小婉Diamond : 如果你记得
老王恋途 : 你师傅收徒弟了，你当师姐了。
YeeEunOrigin__张睿恩吧 : #牢记九一八#勿忘国殇，吾辈自强！
蝌蚪超人 : 勿忘！必还！
惊涛拍浪闯天涯 : 九一八勿忘国耻振兴中华作为一个东北人我永远忘不了这天
阿坤-- : 转发微博
手心的蔷薇s : 你最好
陈大森 : 勿忘历史，吾辈自强！[中国]
蛋卷怪和吐司超人ar : 回复@承包张艺兴的跨:哈哈哈谢谢
蛋卷怪和吐司超人ar : 回复@水可载舟一可赛艇:最后一秒的祝福哈哈哈
大朵_梁沏 : 918。不能忘。
只是一个丶小透明 : 勿忘国耻！
阿杜DLJ : 转发微博
HLY稻草人 : 不去日本
对我而言best的他 : 勿忘国耻，吾辈自强！
劉家亚楠 : 硝烟远去，国耻勿忘
于zzix_ : #918勿忘国耻# [心]
小九尾的小尾巴 : [中国]此生无悔入华夏，来世愿生种花家[心]
熙熙JN : #勿忘九一八#   勿忘国耻，吾辈当自强！
Vera澳洲正品生活馆 : 转发微博
易大师的奇迹 : 假如上天给你一把枪
杨杨楊志勇1990 : 勿忘国耻  少年强则中国强，誓死保护中国。[蜡烛][蜡烛][蜡烛]
HST涅槃重生 : 勿忘國恥
Lms__smL : #牢记九一八#
Lms__smL : #牢记九一八#
路飞-我要做海贼王的男人 : 好像明星中没几个记得的，支持你！
羽落镜 : 永远铭记于心
sakura宛 : [蜡烛]
楓櫻梅 : #勿忘九一八# 勿忘国殇 吾辈自强！！！
Daniel宋昱宏 : 勿忘国耻，牢记教训。
江西中医药大学科技学院绿十协会 : 勿忘国耻[威武]
崔胜铉的老婆阿君呀 : [蜡烛]
请叫娇娇叫娇爷 : 警钟长鸣，勿忘国耻！[强壮][祈祷][祈祷][祈祷]
柒琪琪七 : 勿忘国耻，铭记历史。
Mr亮灬 : 都是清朝后期闭关锁国造成的。
林嗤嗤 : 吾辈自强
钠路多i : 不忘国耻
口天吴的222222珊 : 勿忘国耻，振兴中华！
梁筱桃 : #牢记九一八#
可乐oo_ : 牢记历史，勿忘国耻！
原始协会动物 : #牢记九一八# 勿忘国殇，吾辈自强！
水可载舟一可赛艇 : 回复@蛋卷怪和吐司超人ar:生日快乐~勿忘国耻！！哈哈哈[doge]
0小破孩o : 勿忘，心安。
一生为你痴狂 : 勿忘国耻[蜡烛]
琳JOjo : 硝烟远去，国殇难忘，勿忘国耻，吾辈自强！#牢记九一八# [心]
深沉的包子丶 : 牢记九一八
我是大娃我怕谁 : 勿忘国殇，吾辈自强！
隔壁2叔 : 爱国，从铭记历史开始。。。
白衣少年201508 : 不忘国耻，爱国好boy
冬天的美丽Baby : 前事不忘！！！
没啥想吃的了 : So what?都快得假性应激障碍了
光阴的故事是个果厨 : 国耻永不忘
吴选作 : 铭记历史，感恩当下！
哎呀快看那边 : 八十五年，不敢望
木枼葉 : 918事变，勿忘国耻
WhiteJDT : 千古功臣张学良，一枪不放泡妞忙。东北三省尽沦丧，不抵抗把美名扬！
Ms_斯小姐 : 勿忘国耻，警钟长鸣，砥砺前行！
小清新也抠脚 : 虽然社会仍有不公，但是最起码现在活着就会有希望，感谢先辈，不忘历史。
二白大爷 : 嗯，时光久远，未曾感受。但在有国家的时代，中国强作为中国人才能挺起胸膛。这一点，是海外游子更清楚的吧？
小宋同志- : 回复@河北公安网络发言人:f
眸子里的眼 : 吾辈自强！
珊珊要努力奋斗灬 : 勿忘国耻  少年强则中国强[心]
蜜汁彦祖 : 勿忘国耻 中国加油
苑saosao : 铭记历史[蜡烛][蜡烛][蜡烛]
杜小亮_VC : 转发微博
珊珊要努力奋斗灬 : 勿忘历史 少年强则中国强[心]
WuLi包子加油 : [中国]
娜是我的小公举 : 牢记历史，勿忘国耻
道生一- : 勿忘国耻，自强不息
凡灿系_仙女 : 勿忘国耻[心]
丶杨幂丶 : 牢记历史，勿忘国耻！
巫女之矢 : 勿忘国耻！！！！
BAD--H : 吾辈自强[心][心][心][心]
LCS联创社小白菜 : 【铭记历史上的今天】九一八勿忘国耻！
鹿沐辰7 : 转发微博
只想做个正直的世外高人 : 转发微博
冯运华F : [拳头][拳头][拳头]
小徐牙牙乐 : 勿忘
蘇小贱sxy : 勿忘国耻   振兴中华@李维嘉
用户5843828053 : 勿忘国耻
总有文盲不识我 : 勿忘国殇，那为什么张学良现在还是民族英雄？
candybabyLH : 勿忘国耻，振我中华。
郑川静 : 吾辈自强
凌寒君 : 如果不想重演当年的悲剧，就得时刻警惕。每个人都要努力，要对祖国充满信心！
漫天狂沙风很大 : 勿忘，铭记，自强。国与家，是根。[心]
吉林大学动物医学学院学生会 : 勿忘国殇，吾辈自强[强]
冷光初现 : 铭记历史，缅怀先烈，珍爱和平，开创未来！[蜡烛][蜡烛][蜡烛]
北方有故人十年踏雪归 : 勿忘国殇，吾辈自强。918，不能被忘记。
嘴烂了 : @C-Dreamer-
翼-小宇 : 回复@迷失的世界00105:所以说咱共产党必定是坐天下的。
河南山 : 力量来自于恨。
雾锁江南kkw : 今天9.18。问学生，知道今天是什么日子？他们说不知道。我有点晕。以前，在这一天，我都会给学生讲。今天，我恰恰忽略了，而他们，恰恰不知道！
文清思静_求喜乐 : [蜡烛][蜡烛][蜡烛][祈祷][祈祷][祈祷]
Annie-倪倪 : 虽然我是学日语的，但是我也没有忘记中国的国耻！令人痛心的“九一八事变”。。。
Cinderella--LL : [拳头] [拳头] [拳头] [拳头] 
任山春 : 义不容辞地传递[握手]
亦筱浠Jessie : 转发微博
alex48632 : 勿忘国殇，吾辈自强！
阿宇的故事 : 不能忘记。更不能原谅！时至今日，日本不承认侵华，不承认南京大屠杀。篡改历史，无耻的把自己形容为二战的受害国。参拜供有日本战犯的靖国神社，，，占我钓鱼岛，染指南海，灭我中华之心犹在。
正经人cwz : [心][心][心]
再也不愿吃螃蟹的我 : 深夜来一波#九一八.勿忘国耻#
几里li : [中国][中国][中国]
Vescord : 竟然只看到了你转发
ZJ撒浪嘿 : [拳头][拳头][拳头]
夏有杰哥仰望星空 : 铭记历史
KAJ艾静 : 牢记九一八[爱心][爱心][爱心]
糖果玉o3o : 勿忘
Bird-黄 : 铭记历史，勿忘国耻[蜡烛]
RunningBible : #牢记九一八#，勿忘国殇，吾辈自强！
小陈tea : 勿忘国耻，振兴中华[强壮]
阿吉吉马六甲 : 牢记历史 祖国昌盛[心]
-天蝎公子- : 国家不强大，一定受挨打[good]珍惜今天的中国
卢钰谣 : 勿忘国耻。
cccici钱多多 : 回复@lovlilys:我早上就看到了
Eros_浅笑安然 : 勿忘国耻，吾辈自强#牢记九一八事变#
二桃子Y青年 : 勿忘国殇，吾辈自强！
李维嘉 : 牢记历史，勿忘国耻！
抗日老兵新遭遇 : 回复@卡路里爆表:评论不支持发送图片，谢谢你的正义支持！[作揖]
________S_J_ : 媒体，明星。无论如何多忙，请利用好你们的权利和人气，多多宣传历史。没国哪有家。
雯_vili : 勿忘国耻
EN小桐 : [拳头][拳头][拳头]
Ben十三 : 勿忘国耻
薛之谦的黑色眼镜框_ : 现在这一辈人都无法体会到那一代人的悲壮…体会不到今日的幸福是谁创造的…金膺和孩子们上918事变的课…和孩子们哭成一片…警钟长鸣，国泰民安！勿忘国耻！！！那些对着日漫说中国不如日本的中国人见鬼去吧[中国]我是中国人我爱中国[中国]
Hello唐小杺 : 勿忘国殇，吾辈自强！#九一八85周年#
SuZy_酥橙xi : 勿忘国耻 爱我中华[泪][泪][泪][心][心][心][拳头][拳头][拳头]
狗狗茂茂 : 警钟长鸣
Liang钰莹51 : 中国[心][心][心]
用户6025836429爱你祖国 : 勿忘国耻！
肖思瑶_Anniy : 勿忘国耻 振兴中华
童先生sir : 国家兴亡  匹夫有责  吾辈当自强[拳头]
梦想再远也只是遥不可及 : 牢记历史 勿忘国耻 中华儿女 自强不息
丑喜人了 : 爱你yy17835393397要不是你   我怎么会变得这么美
TakyC : 转发微博
一爱到死 : 勿忘国耻，理智爱国
洪山宝塔 : [围观][话筒]  勿忘国殇，吾辈自强.。。。
风中丶浅笑 : 勿忘国耻
沛雨而下凡凡 : 上午听见防空警报！牢记历史，吾辈自强！
我当然兹磁啦 : 85年前，我们被别人打。85年后的今天，自己人打自己人[微笑]汕尾WK安好？
