An_瑾i : 多忏悔比多狡辩更容易让人相信
南门公子sue : 人都死了你们还想怎么样
蓝冰儿i : 导演就了不起吗，怎么可以侮辱人
Arun1991 : 其实所谓的网络暴力应该就指向他们这种不配做人的人…而不是指向像Kim一样善良的人…现在多希望他们两当中一个人的死换回Kim的复活
喵檬檬 : 虽然不是粉，莫名的心疼
張鶴Sunflower : 回复@张靖靖:难怪国内影视剧烂片横行
用户5649701054 : 这俩死球导演怎么这副德行，他们害死了我们的kimi,以后他们拍的电影拒绝看。没有素质的导演，太他妈垃圾的，你就不是你爹妈养的吗？希望你们以后的癌症。
Steffilikeme : @_Mark方 [悲伤]
芝士奶盖加珍珠 : [弱][弱]自己人撑自己人有意思？官大压人有意思？间接性谋杀还理直气壮有意思？死者为大，公布真相个鬼！
寻找夜礼服假面 : 回复@天边一朵云_U:人肉
我是焦宝宝的麻麻 : 这个导演在蹭知名度？
淡定姐的春天会很棒 : 气死我了，第一次在微博里评论，我表示以后这两个导演，所有的电视剧电影都不看，心塞[泪][泪][泪][泪]
冷宫娘娘 : 一个人连死都不怕了 鬼知道他经历了什么
等你说我回来了 : 说再多又有什么用？kimi也回不来了
任小涛VJ : 这种18线的人还敢自称导演 自导自演 下地狱去吧 死不足惜
瑾酱需要大hughug : 他已经安息了，真的真的真的请你们放过他，别拿他的任何事情来做文章了[泪][泪][泪][泪][泪]
bogummyyo : 这导演也是恶心
怪咖女王恰恰盼65076 : 车径行是谁？杨文军是谁？   我只认识乔任梁！！！
suk嫁给中国鳗鱼吧100 : 是你们两个害死我们最爱的乔，你们两个把他还给我们，你们到地狱也不得好过的，爱他的粉丝你们说对不对呢
shirleylian : 人在做天在看[闭嘴]
天边一朵云_U : @寻找夜礼服假面
Kimi乔Smile : 你导演了不起么？说白了你就是嫌他不是大牌演员，你瞧不起谁啊！要是一线演员你会这样吗？会骂么？你骂他之前你不会问清楚情况吗？怎么死的不是你，他就是被像你这样的人给逼死的
张靖靖 : 回复@張鶴Sunflower:我真是服  同行同业怎么就不能相互理解  [伤心]
用户5645028933 : 心疼
S星太子 : 这俩混蛋在乔出事后立刻删掉微博，死不认账，没有丝毫后悔
Facebesideee : 还有完没完啊这是 逝者已逝不能让他安心走么……不过讲真 进了剧组没剧本临时写剧本这样的团队也能运作而且还能有导演 真是颠覆了我对这一行业的认知[微笑]
Esther玲 : 妈的，好生气！真相！！！！！！
莫及160 : 就不能让他安安静静地走吗？
甜甜6054 : 这俩导演是啥玩意？有什么作品？谁能给我普及普及，表示完全不知道。以后发微博！别在那指桑骂槐，有本事就直接点名啊！在那叫唤又不敢点名！怎么？怕人家戳穿你啊！有没有点人性啊！说话还“你丫”，素质可真高啊大导演！想封杀是吧！我们以后都封杀你们！同意的顶起！
LYYtaeny : 娱乐圈真的很乱。杀人于无形、
W想要的简简单单 : 真的很心疼，鬼知道他经历了什么[悲伤][悲伤][悲伤]
小优雅shuo : 人都走了，就不要争了，让他好好的，安安静静的去粉色天堂。你们这样有意思么？都什么破导演。都那么厉害，让KIMI回来啊，当面对质啊。[悲伤][悲伤][悲伤]
拉屎的猴子 : 心疼  这世界到底怎么了
莲儿凤 : 回复@倔强的温柔--:抬头三尺有神灵，坏人有报应的
小小少年昊成 : 人有张嘴，但请不要去说重伤别人的话！不要触碰别人的底线，请互相尊重！
翟璐sunny : 入土为安，逝者安息，大家能不能有点起码的同情心？
王海榮兒 : 导演太侮辱人了，太过分了
云之seeyou : @Fiona--zhu @李晓琪_lxq @光芒万丈的李雯子
用户x47n11f05w : 死的应该是这个导演，封杀这个导演[弱]
我是陈伟霆的大当家 : 这种导演，良心何在？天地不容！！心疼kimi[泪][泪][泪][泪]
Ajing20863 : 我想说所有黑过kimi的人你们难道不会觉得良心不安嘛，对于喜欢的演员你可以选择支持她们的作品，不喜欢就不要看，我对古力娜扎无感，所以她的电视剧我基本不看，但是我从来不会去黑任何一个明星
小猪在晒太阳zq : 垃圾导演
芥末小学酥 : 杨文军！我记住了！以后你的电影我们拒看！
LHAYR : 你是导演了不起吗。没有演员你是导演一个人怎么演一部戏，演员和导演应该相互尊重。让他安安静静的走往属于他的粉色天堂好吗
A刘刘刘YH : 如果有一天我死了，我一定不惜一切代价去内个导演家吓死他[微笑]
籽仁儿 : 人都不在了，啥也别逼逼了，逝者为大
明亮的世界里面k : 公道是吗 我帮你讨
梦逃天堂 : 人都离世了，请你们都闭嘴吧！不要再消费他了，还他清净吧！他活着的时候得不到清净，既然已经走了就让他安静的走吧……
花小七七x : 善良的小乔
花小七七x : 这样的导演就是杀人犯啊
景与情 : 这人还要不要脸
Jasmine茉莉R : 原来他那么不容易[泪][泪]心疼他
琳琳_1705 : 现在说这些还有什么意义，到底有几个人真的是为了他好，他都走了还要被你们当做博弈的筹码吗？人在做天在看，都省省吧！
倩女daytime : 全球封杀这个导演
星星bjing : 已经没意义了[伤心]
XIAO雪零距离 : 良心何在。。
小宝儿十六啊 : 人都不在了，还说什么有的没的。不管事实是什么，我们都应该记得别人的好，不是尖酸刻薄甚至拿死者起话题搏新闻上热搜。死者为大，还大导演呢，多大的能力啊，还联合协会四百个导演一起抵制，切，最基本的尊重都不懂，听都没听说过的导演，还耍大牌呢。
逆光恋人 : 其实说这些都没有意义了，他都已经走了。。。
美丽的孩子他妈 : 我去，什么导演。[吐][吐]
熏香的月亮2015 : 演员这个行业是表面风光，他们内心的感受是我们无法体会的，需要多么强大的内心才能撑下去。
得不到的我宁愿不要08435 : 这个导演是谁，乔任梁的死跟他有着重大的关系，不能就这样算了，这个导演真不是人
练练小小旭 : 让他安息好嘛！
芝士小天shi : 终于知道中国影视业为什么止步不前倒退的原因，导演理事会有这么几个具有代表性的滚蛋玩意儿，会潮气蓬勃发展才怪，在他们圈子关系好坏才是硬道理吧？当然，好导演也有，即使有可能也会被这类渣所孤立吧！恶心，恶毒！看了他们作品介绍，才知道人品跟票房挂钩，那咱就看看胜利是站正义这边还是站您那里
咔楽B薯片 : 这个扑街导演就应该向KIMI 道歉！人死了连最后的尊重与道歉都没有，这导演配做一个人吗？[怒][怒]
看海去不 : 这种导演导的片子从此都不会再看了，你们间接的害死了一个那么努力那么青春的大男孩，也许没有你们的污蔑乔可能现在还是好好的，请问这位导演你晚上睡觉能安心吗
朋影随行千 : 气愤 不能放过这个导演
老弗爷退休了 : 弱弱问一句 拍的戏叫什么
YUJIE范儿 : 以后大家不要看这几位导演的电影，
老弗爷退休了 : 弱弱问一句 拍的戏叫什么
YUJIE范儿 : 以后大家不要看这几位导演的电影，
晕鼠鱼88 : 这导演也没倒出个啥啊
都说她似梦 : 这个导演是谁
姐是娃娃 : 所谓的导演是哪根葱？该走的是这位吧。。
楠楠儿哒 : 人在做 天在看 这导演我醉了……
女王范仙儿 : 没良心
长了腿的保温桶 : 回复@佳汝Yee_:是啊，唾沫能淹死人，这句话是有真理的
弗兰克尼 : 回复@夏季百年草:那他们又凭什么逼死乔，乔又不欠他们的。导演了不起吗？导演就可以三点下戏，6点又上戏吗？都不给人合理的时间休息？既然导演认为自己牛，那就撤了乔好啦，何必在微博上暗骂？钱要拿，本事又没有，又要骂人，哪有那么好的事？没这个本事，导演就夹着尾巴做好自己的本分好了
xiao晓宇宇 : 哎呀我去，导演真的很了不起啊！还联合封杀，你们是人吗？
半五十的包子王子殿下 : 我不会去他微博骂他，我只会骂一句垃圾导演，好，结束。
毕竟我的腿有两米长 : 杨文军到底是个啥啊！
想念却不想见得人Jzw : 好心痛
易爆炸的小魔女 : 把乔任梁还给我们[泪][泪][泪]
XFMIMA1314 : 多好的一个阳光少年，你们怎么忍心？听说他的病是进你们剧组才变严重的，可想而知你们是多么恶劣的对待他。你们就是凶手[泪][泪][泪][伤心][伤心][伤心]
Bobai倩影 : 作为路人，真的很替他感到可惜，这么年轻，如果当时能努力让他尽量去治疗或许就不会发生这样的事情，他的父母是多么悲痛。
毕竟我的腿有两米长 : 不想看见kimi的任何消息，尤其是这种特别让人气愤的消息，一看见他消息我就想到他已经不在了的事，心里堵得慌
A_高气气 : 这样的导演还不如嗑药赶紧死去、没良心、他也有孩子、别人对他自己孩子也这样吗、这样导演才是贱命一条、恶心[弱]
斌斌宝贝赟丶why : 这杨文军导演也太不要脸了吧，人都被你们逼死了，还满口胡言乱语！太不要脸了！你现在哪来的勇气说这些话？
我爱你你爱他他爱她mistakenlove : 大家请喷死那个导演。是的点个赞
月光下de云烟 : 已经这样了，你们还不放过他，是人吗？
沥Sir : @Ceasez 看
夏简芷苒 : 这导演是谁啊？怎么没听过啊？导演逝者为大这基本的尊重和礼貌都没有吗？就不能让他安安静静的走吗！
佳汝Yee_ : @长了腿的保温桶 感觉他的人生有些坎坷呀 遇到一些不没人性的人 是人遇到那么多挫折也会受不来
imoney笑靥如 : 大家都是有眼睛的，比起贵圈导演自以为大牌，我们更相信一直在做自己的KIMI 人在做天在看 谁是谁非的结局再也换不来kimi带给我们的温暖
走着走着阳光和水都在 : QMMD！如此没有人品也不为自己家人考虑下福祸！
Hi-栗子姑娘 : 我不认识导演，更不知道他有什么好的作品，但是我知道乔，我们都很喜欢他，虽然不是他的vip
启芷 : 别再炒了，让他安安心心的走，不行吗？[泪][泪]
殇璃雅望 : 回复@NeverStopTrying:我这是质疑吗？我只是表达了我的看法，，并没有说任何不好的话吧？
_李李李八一 : 活着的时候没见你们夸他一句好，他死后说这些有什么用…是为了减轻自己的罪恶感吗… 那你们可真的罪无可恕、罪孽深重…
Better-zm : @庚澈大旗永不倒
宝贝20111111 : 真正没人品的也许正是这种没利益的导演！
牛什么_ : 你们说，这俩个人晚上睡得着吗
imoney笑靥如 : 真是对它们呵呵....心疼米
专业撩蓝湛的wifi : 公司为什么让他接这样的剧？！
上天拉 : 娱乐圈都这样，那些不出名的演员肯定是会受到不公平的言论的，就是是平常的生活工作，也总会有小人来陷害自己。还是要自己心态好，不要把别人说的所有话都放在心上。愿kimi能静静地走
JERRY-琳 : 没人性，太过分了
Syyyy阿- : 就这种人也配做导演？
朕不是很瘦 : 妈的这导演脑残，这时候还不放过他
_Wangyawen- : 回复@Xiemenglan-:之前看到这些真的好气愤啊 演员也是人 为什么要拿出一副你拿我片酬我要你命的姿态啊 真恶心
杨婷22 : 不想再看这两人当时说的那些话，太伤人
我的小狗叫小豆芽 : 以后不看那个导演的戏
幸福的lucy2013 : 什么导演你素质何在？
水晶球de问号79656 : 如果我们粉丝不懂演员的辛苦，作为导演还不懂吗，如果作为内行人还做出如此行为，确实挺心寒，呼吁那些送别Kimi的明星朋友们，抵制这两个没有良心的导演，就当为Kimi，和以后的演员朋友们在有这样的遭遇，请给予明星们明确的法律条文，保护他们好吗，真的再也承受不了这种打击了
幸福的lucy2013 : 导演素质呢
用户5661890213 : 哎，在圈内没后台也不好当啊，这明星→_→
用户5661890213 : 哎，在圈内没后台也不好当啊，这明星→_→
mo眸 : 还教授！哪里的大导演！你有什么作品！你是几流？18流！19流！明摆着欺负乔任梁吗！
Amy嬰語 : 他們就是殺人犯！！
nicomom866 : 那些所谓导演太过分了。
喂猪撑腰 : 你们就吵吧，他永远回不来了[泪][泪]
Smh欲言又止- : 没听说过这个导演，垃圾！
月笙不姓杜 : @dmndd @无限循环环环环环环的普金
Smh欲言又止- : 这种导演就该死！什么人这是！赶紧去死了吧！
茜茜XUE : 都是什么导演，听都没听过[微笑]
最美时光遇见你一敏镐xi : 回复@朴偶吧的迷妹哟:公道自在人心，愿逝者安息[爱心]
mo眸 : 工作的事，私下解决。侮辱！威胁！重伤！直指有抑郁，揭痛处。一看就不是什么君子行径。
Johnny小呆 : 根本不认识这路人甲导演  还上来刷什么新闻啊
Johnny小呆 : 恨
就离你几毫米 : @abmyo
Lan懒咩咩 : 是你们这些不可理喻，自以为是的人，导致了他这样，你们这辈子都不值得被原谅[拜拜]
王闹闹i90292 : 去车径行微博下骂
豆毛爱吃豆 : 大？导演？？不好意思，从没听过这人名字，可能是我孤陋寡闻了吧，但我知道乔任梁[微笑]
小乘hh : 逝者已矣，他不会在乎的了
