多多的胖哥 : 车子越是烂，开车的就越是屌，屌丝得一B，炫耀自己有车了，吗的智障
希望一切都是蓝色的 : 回复@ctinyj:总觉着还是原装的好，花钱买的，总觉着舍不得[脸红]
海边小言 : 回复@遗梦_江南:也就头像可以评价一下，否则你让我说什么？
急急如令令小涛爹 : 哪一条高速  G20？@人民日报
佩文森特 : @静静想一个人静静-
来二斤牛肉先 : 大货车低档踩油门，都不用按喇叭[doge]
小船儿荡起波澜 : 死了算了，省的下次无辜的人开车遇到就糟糕了
一块腹肌的妞儿 : 视频过程不完整，下这么早的定论谁对谁错，尚早吧…
东致-初原创 : 白车太坏了吧？为什么要这样啊？
龙卷风一样的男纸 : 轮胎爆了
孩子我不能失去你 : 求求你们救救我
心事重重的沙发 : 玩的没我好，放钉刺带啊
向佑昔 : 碰碰车
月下青衿染蒹葭_ : 警方介入调查，嗯，应该是调查背景去了，看看能不能管，能管就罚两千，不能管就当没发生，很好啧啧
ZZzzz了个秋 : 回复@陈炜剑_:于是 横尸遍野么[眼泪]
心情迷宫tua : 一人我饮酒醉，醉把前车怼一怼，二人我不服谁，就速飙车谁怕谁，你撞我保险杠，我挤你车子没商量。二营长，把老子的杨永信拉上来，这两人须要治疗！
跖窳觋 : 必须直接一律按危险驾驶罪定刑，任何部门都不能以调解方式处理
卖女孩的yura : @Sen-m1tsuji
遗梦_江南 : 回复@海边小言:卧槽 你在网上调戏良家妇女啊
德耳塔delta小于0 : 每人罚上个百八十万，在判上几年，终身禁驾。毛病都是惯的
陈炜剑_ : 允许持枪 就不会有种烂事发生了
执笔LLL : 回复@徐瑞道9625:看吧……妥妥的弱智
iAm阿申 : 秀的飞起[微笑]
潘太帅同学 : 回复@江左一城:看了速度与激情还是看了极品飞车？[微笑]
江左一城 : 黑车技术太烂：教你们一个方法怎么弄翻白车，白车从中间车道向超车道别黑车时，黑车猛加速方向猛向右打将黑车右前轮撞向白车左后轮前方一个轮胎位置那里，就可以把白车顶到路边绿化带去了，然后黑车松油刹车握紧方向盘约一秒后回方向盘。完。
leon-1010 : 有病，吃饱了撑的，想死换个没人地方
应悦尘困死猫 : 估计都不想活了
可是我还没 : 生死看淡，不服就干。
XXX081 : 可以可以 这很山东[笑cry][笑cry][笑cry]身为山东人……感觉一身正气哈哈哈哈哈哈哈
老朋友_91710 : 作死
曦幺幺_ : 这种人一辈子不准开车
香城雪子 : @i然儿 @晖Magician
o潘多拉拉89776 : 高速上，找死
你永远都看不到我心中的泪 : 不会开车，不过光看这段，白车不是故意的么？你让人家先过去怎么了。蛇形影响后面车辆行驶。太作了！
Baby来一发吗 : 回复@tomotomohisa:我不会这样[哈哈]
徐瑞道9625 : 回复@执笔LLL:傻狗 使劲叫吧
青蛇腾舞 : 严惩
海边小言 : 回复@6673yyy:你的头像比较漂亮。
小茂哥儿 : 你玩过GTA V吗
LauLawliet : 直接拘役
河道插眼被淹死 : 这么宽的车道也能发生争执 我是服的
作家韩晓倩 : 珍爱生命，远离飙车
马答应 : 男司机？？[微笑]
等待清清 : 回复@薛小扁:[good][赞]
骑着驴撵宝马 : 都是钱烧的！有本事找个空地对撞去，看谁先死。
我是杨洋咩咩咩 : 应该是黑车司机被气到了，多次想超车都被堵，感觉白色的车故意的，真缺德？
小PQ的幸福生活 : 🐂🐃
tfddb : 这互相不服输的劲头，用在哪不好，非得用在作死的上面！
陌外小仙儿 : NO ZUO NO DIE
Boilingblog : 自己不要命，别害别人啊！
怡路-有你 : 违法乱纪的请严惩！
u_uRainbow : 最讨厌那种乱加塞的  别人都排队 就你有本事 就你厉害能加塞是吧  就不让你
猫小狸爱吐槽 : 你俩想互相碰就面对面的怼，看谁车速快，看谁死的快。
执笔LLL : 回复@徐瑞道9625:我不是针对你 但我就是觉得你这个说法像个弱智
是舍长不是色长 : 就不能把车停旁边，下来打一架吗？
喜欢喜欢超喜欢x : 这@君还记-一袭水袖丹衣
薛小扁 : 回复@等待清清:这种斗气司机应该同归于尽才好，是对人类劣等基因的有效淘汰。
双手插兜说声嗨 : 这种开车的最好俩人打个头破血流，能死几个死几个，别给大家添堵。
木卯博元 : 作死可以，别殃及无辜就好，阿弥陀佛！
绷绷绷不住了 : 白色越野如果是霸道那我就理解了
临沂李官 : 终生禁驾
朱德康 : @爱王杉丶
nswdbzsc : 真是够了[生病]
嗯哈哦哈 : 起亚亲哈弗，哈弗不给亲，一路首.我陪你缠缠绵绵到天涯[吃惊]
哈气小姐 : 疯啦咋滴
新余婚嫁网 : 这两车不用多说，估计平时就都很拽，马路是自己家的一样，都不把别人放在眼里的那种。正好碰到一块就掐起来，最好两个一起撞死掉，免得祸害人间。
面朝大海的农家乐 : 长城H6啊，最吊的一群，人车绝配。
种花家的完颜酱 : 山东高速路好走，也不带这样啊
蔚蓝的天清澈的水2016 : 会不会，警方已危害公共安全罪进行逮捕？？？？？？？？？？
开心时刻渐少 : 以危险方法危害公共安全罪
我_心_里 : @我_姓_李 厉害了
24K纯二青年 : 两破车挤个什么劲？
le-floater : @文刀议
程-尼-玛- : @聪葱骢冲
故吐纳新 : 路怒症，病得不轻，得治！
基层平民世界11 : 什么素质？
WANg微微11 : 祸害人
杨深梦断2015 : 两司机必须刑事拘留，吊销驾照
厦门利易工贸有限公司 : 不能这样
夜空中最亮的星XKY : 就想问问还有谁[doge]
CHARRY的幸福生活 : 死刑！要不然害死别人！
是蜜喵啊 : 回复@等枫红染秋季等相遇z:反讽有什么绝对不绝对的，毕竟他们说女司机时话可比这个难听多了
玩命滴雨子 : 耐心哪去了？
辛辛-Foreverever : @Come_as_KEN_is
远方止一弋 : 凡事斤斤计较，何苦呢[汗]
多汁杏鲍菇 : 拍片现场，不明群众乱入[笑cry]
地球的另一端LY : 判刑
如鱼上岸jeremy : 直接吊销驾驶证，终生不得考取！
Jeyton : 这种就应该下半身残废度过
郑州市城市管理局 : [doge][喵喵]两位，当你们两家的老老小小看到你们酱紫开车，一定不会觉得你们是在为这个家争脸！[拜拜]
还剩四片土豆 : 后面要是辆挂车，俩都没了，渣渣
云起清朗 : 高速上这样。。卧槽。。后面来一辆高速大货车就boomboomboom～啥都没了～这不只是玩自己的命也玩别人的命啊！永久吊销驾照！
Dang宁_ : 路怒也是有原因的，例如我们这某些出租车随意抢道加塞。还有某些车不停按喇叭。。
等枫红染秋季等相遇z : 回复@是蜜喵啊:看的懂 只是你的话有点太绝对了
平雅W : 遇上俩暴脾气，这样的人早晚出事
菜菜-蔡晓兰 : 回复@酸菜就酸菜:。
浅浅谈谈有 : 这时候为什么没有大货车、让他送你们一程
叮咚响的相机 : 想起了头文字D里死亡胶布战那集： 秋明的AE86只有进拆卸场的命！ 撞击失败…… 我的EG6[泪][泪][泪]
酒足饭饱撩2嫂 : 回复@春和景明和你:不要命了
活在当下NF : 这个应该以“危害公共安全罪”定罪
我就是不生气啊 : 狗咬狗一嘴毛
布达拉-寒流 : 俩车主都应该判刑！危害公共安全罪
迷糊錢多多 : 我只关心死了没？[怒]
张泽鹍_ : 是不是聊城的？
Fats_Shady : 搞事情？就知道搞事情，命都不要了，还威胁到别人的生命安全
物理教师001 : 最好找个没人的地方，你们自己喜欢怎么挂，我真的无所谓，只是，别影响别人。
黄飞老师 : 我们山东人上个新闻，要么是青岛大虾，要么是临沂电信诈骗，要么是烟台冰雹，这下好了又多了一个。心塞
桐谷珺瑶 : 尼玛的想死去秋名山啊！
zyquscle : 必需以危险驾驶起诉
为什么不呢why : 狗咬狗真好玩[doge]
beyond行者 : 一般平民不敢这样撒野吧
beyond行者 : 有关系？
可爱的木头人 : 亲眼目睹了两辆事故车，两辆车距离较远，当时还在猜测发生了什么事故[吃惊]
Hood-Yao : 以为自己是潜在的灵魂车手……需要被激发…
髙巐 : 智障？
修车老头 : 回复@手机用户WANGKAI9781:两车道 济青无误[微笑]
杰客无为 : 评论更精彩。
o辉色轨迹o : 这样的都应该送前线去打仗。
福星高照DY : 拿命开玩笑呢吗？[疑问][怒]
手边流淌的河 : [吃惊][吃惊][吃惊][吃惊]
阑珊处是你 : 其实他们是在拍戏呢
Hantor : 黑车司机技术太差！
hide侠 : @___Lyyydiaa
木昜飞扬 : 澎湃新闻，今后无论真假一概不信！
马大爷的姿态 : 这俩司机是山东倔县的人
-Ayalkomod : @郑郑症
ctinyj : 回复@希望一切都是蓝色的:主要是人太好了啦。不然撞上去，你刚好可以去翻新下加做个保养什么的[挖鼻]
希望一切都是蓝色的 : 回复@海边拾贝壳的Boy:贵的也买不起啊，只能忍着[泪]
希望一切都是蓝色的 : 回复@ctinyj:关键是心疼自己的车啊，要不真想直接撞上去！
希望一切都是蓝色的 : 回复@袁硕七年:对啊，上次我妈开车就有个直接冲进来，把我家车镜子都擦了，正好在收费站，我们说他，他还说他就要跑这条道儿，横的要命
马君_诺亚 : 不作死就不会死，以危险驾驶罪论处
军林天下winner : 直接去跳河快点
轻舞飞扬75307 : 碰到过这种车，你一想超车前车就要变道。
轻舞飞扬75307 : 碰到过这种车，你一想超车前车就要变道。
hua芳馨 : 香港警匪片看多了吧
虎的牙牙 : 严重危害公共安全
击败独孤 : 找死别害别人
酸菜就酸菜 : @菜菜-蔡晓兰
6673yyy : 回复@海边小言:不愿意。他全责就撞我。啥逻辑。。。杀人犯还全责呢。杀个你，杀个你家人。杀你家狗你都不乐意。。。
手机用户2001936167 : 学谁不好，学三星
守望夜空中最亮的星 : 这不就是杀人？害自己更害别人
白开水administrator : 碰碰车
白龙马的生活 : @小老虎和小松鼠
陈宇江 : 保险不赔
橙恋2010 : 作死
理游 : 虚伪的‘人性’让没人性的渣滓越发的猖狂，邪恶的流氓法制让违法犯罪成了一种‘生活方式’！虚伪的‘人性’把人的生命尊严变得毫无价值。变态的法制规范造出这些一边藐视残害生命一边将自己伪装的道貌岸然的‘变态’渣滓。在流氓法制社会，能实现的只有噩梦！畜牲不如的渣滓搞的‘法治’比邪教更邪恶！
爆笑的青蛙 : 终生禁驾最合适
徒步旅行的海龟 : 俩人死了吗，死了在报道吧，不管谁对错，这样就是在找死
高焕垚 : 回复@芍药_花:人争一口气，脾气太暴躁了
简丹幸福90 : 回复@imckx:就你好
张大叔很潮丶 : 找死的节奏，
猜猜猜谁能猜出来 : 从视频内容来看，白色车主命不会太长！！！
V光哥哥 : 回复@飞yao:牛逼！这些人不要命了❗
齊蟿 : 行车记录仪车主，你也是不要命的主[好棒]
用户5714464108 : 涉嫌危险驾驶，危害社会公共安全，扣12分
勇2018 : 回复@李光新_leo:百度旅游特邀行程规划咨询师
阿亮微电影 : 现实版头文字D，给101分不怕骄傲
别让时间非礼了梦想1919 : 且行且珍惜啊，[祈祷][祈祷][祈祷]
脑残的劫后余生 : 摇号快六年了。前三年摇不上号，只能骑车上班，结果被车撞。现在又三年过去了，只能走路上班。我恨摇号，我诅咒组织摇号的人，诅咒组织摇号的人都头上少块骨头。
佑得 : 碰碰车确实不是娱乐项目
imckx : 真心讨厌山东人
aeflor : 《速度与激情8》开拍啦？？？？[吃惊]
许伟尧_340 : 呦～极品飞车啊[笑cry]
应星刘_218 : 还是素质和教育不够普及，大家都要礼让三分。都是同胞啊，有本事去跟日本和美国搞。
山东反邪教 : 不是斗气，是玩命！
飞yao : @V光哥哥 看看高速碰碰车
辍拐 : 危害公共安全当场击毙才是
爱国偏多屠狗辈 : 黑车是起亚，大家别买，掉保险杠[喵喵]
floooo_ : 然后发生了荒蛮故事的情节
謝寧吶 : 这尼玛是玩儿嗨了？
律政阿勇 : 两人一块死了最好！
罗德里格斯张 : 两个都死了吧，从此社会上少两祸害
冰舞水寒 : 这白车司机够贱的
_Song0809LoveU : Mdzz
臭鸡蛋味的老司机孙耒 : 是我的话早把白车撞翻了，死了他活该…这路是你爸铺的？
是蜜喵啊 : 回复@等枫红染秋季等相遇z:这是在反讽，提示那些不要动不动就往性别上扯的人
等枫红染秋季等相遇z : 回复@是蜜喵啊:.....前几天不是也有一z4女主撞下了车的卡宴男
FDT2 : 钱多了骚得慌
有爱的阿尔萨斯 : 命就一条，只有丢了才知道。
用户5868236294 : 搞什么……高速路还斗气，真是不但不怕死还要拉别人一起死……
大积极小积极 : 有钱烧的[眼泪]
台灣-寵兒 : 澎湃新闻怎么总是拿别人的视频打上自己的Logo，挺恶心
