出门忘了拉拉链 :  看大片[din汗] 
__梁颖欣 :  [v5] 
华山龙柏行古镇 : 回复@张庶民:我说的大众不是网络暴力人群，不是90后甚至00后，而是已经成年的安稳生活的普通老百姓，整天被这些信息轰炸，污染眼球，何其不幸！打个比方，我父母不上网，但这种信息满天飞，一家人都这到了，不知道原委，就知道一个演员死了，关我们什么事？
我姓程我心诚丶 :  [g惊讶1] 
x嘟敏俊西 : 善良的人
ArtFishes : 希望你下辈子能成为一个天天开心的人[心][蜡烛]
额奏是额 :  [cai插眼] 
张庶民 : 回复@华山龙柏行古镇:与大众何干？让人了解抑郁症算不算有关？让人重视抑郁症算不算有关？让人重视网络暴力算不算有关？你知不知道因为类似的事件现在正在出台关于网络暴力的政策？没有这种戏子，没有这种曝光度，谁会重视这种事？而像你这种人太多，不反思，只看表面的结果，我们社会才会像这样。
mizucino : 都不上班
Floral_fairy_ :  [摩羯座] 
安洪浩 :  [上火] 
雨落花涧笑 :  [恐怖] 
燕玉不是艳遇 : 对不起，在你离开之后才了解了你。kimi再见。[悲伤]
雯Dance :  [din分身2] 
小小孩儿KIMI : 回复@镜子jingjing:看看我的名字就知道我的心有多疼，用了十年的网名…妞儿要好好的，好好活着…
_我是陈小小 :  [ali飞] 
华山龙柏行古镇 : 回复@张庶民:就问一句，他的死与大众何干？这么轰动想怎么滴？我这不关心娱乐圈的人整天都被轰炸！悄悄的来悄悄的区多好！这都是媒体拿死人炒作的结果，可怜的戏子无论生死都被人利用！
闰土钢叉猹 : 讲真 没听说过此人 有多少人知道他有什么作品 中国网民跟风无敌
果果果_酱 :  看大片[bed凌乱] 
__fanfanfanfan : 一路走好。
shirley吴- : 不是粉的我，刚开始得知这个消息以为又是谁在恶搞，之后会不了了之。直到第二天，很多明星再发这个消息。我才知道是真的。他笑起来那么邻家男孩，那么暖。这样离开，真的心疼，看到今天他的追悼会，更是心疼泪奔。
无言的结局李 : 一路走好
zizi喵啊喵 : 现在听了才知，你的歌好好听。走好
镜子jingjing : 回复@小小孩儿KIMI:好多人都说喜欢秋天 可是我对于秋天的到来却是惶惶恐恐  因为我爸也是九月份走的。然后这个阳光大男孩也在这个多事之秋结束自己那么年轻的生命。好多明星走了或者怎么样都一看而过。不知道为什么却对乔任梁那么多不舍  真真是不想说走好。好想告诉他别走。那么好的生命怎么就随便放弃呢
Simon赴美生子美国月子中心2 : 美国生孩子好处： 1、享受美国13年义务教育小学到高中免费。 2、申请美国公民才有的奖学金，1%低利率助学贷款。省上百万人民币。 3、无条件留在高收入的美国工作。 4、享受全球180多个邦交国入境免签。 5、宝宝18岁前在中国生活，仍无条件是美国公民。 6、孩子21岁后，父母可以不受配额限制移民美国。
阿戈里巴乔夫 : 我也是呵呵了，没死之前没见多少人关注他，现在倒是站出一大堆人，跟风真严重
现实总与梦想背道而驰 : 昨晚路过的时候鲜花一车一车的
Simon赴美产子美国月子中心 : 美国生孩子好处： 1、享受美国13年义务教育小学到高中免费。 2、申请美国公民才有的奖学金，1%低利率助学贷款。省上百万人民币。 3、无条件留在高收入的美国工作。 4、享受全球180多个邦交国入境免签。 5、宝宝18岁前在中国生活，仍无条件是美国公民。 6、孩子21岁后，父母可以不受配额限制移民美国。
山有木兮木有枝u : 看着看着就哭了
hello逗比神经123 : 走好kimi[蜡烛]
韩小鹿 : 活着的时候也能这样好好的对他，也不至于
J-末儿 : 看的眼泪都出来了，不是他的粉丝，都觉得接受不了，这几天在听他的歌，脑子里浮现的全是他各种的笑脸，怎么会，怎么会就这样离开了，到了那边Kimi你可要照顾好自己。。
坏孩子还没学会走 : 不是粉丝，看着照片突然好难过，眼泪冲出来
猫人招商部 : 一路走好
白杨念母 : 一个民族的悲哀...
隐形人小 : 演员就是会演，那么多演员又都跟他有多深的感情？？？ 不管怎样，逝者已去，愿他安息，不要各种号刷他离开的消息了，这不是对逝者的尊重，这是演戏，这是消费。~~~
凡心左儿 : 始终无法相信，带给我们阳光的你真的离去，愿天堂都是你爱的粉色！[蜡烛]一路走好。
你好吗啊1232 : 你才智障呢[鄙视]
HFWJXHNLD : 一个路人，都已看哭，[泪][泪][泪]
小剩女的春天 : 失恋第二十三天，秋分之后冷飕飕   昨天是秋分，晚上睡觉忘记关窗子了，早上一起来救拉肚肚了[悲伤][悲伤][悲伤]叫人命啊！[晕][晕][晕]小朋友们记得秋分来了好冷啊！要穿外套和秋裤了，晚上睡觉也要关窗子了，要不就像我一样要拉肚肚的啊！ 好疼啊！今天早上要吃什么早餐，煎饼果子，肉夹馍，推荐？ 
暴走的大象腿 : 回复@海水之女:不要戏子来戏子去的，尊重点，艺人ok？
王炳旭- : 不哭不是女的
就叫浪浪吧 : 回复@海水之女:国人的五大特色 1.不愿为共同的利益奋斗，却愿为社会的不幸怒骂。2.不愿为长远的发展谋福，却愿为眼前的小利冒险。3.不愿为朋友的成功鼓掌，却愿为陌生的悲惨捐助。4.不愿为规则的执行所累，却愿为潜规则的适应受罪。5.不愿为强者的坚持援手，却愿为弱者的妥协流泪。
Elegant雪 : kimi走后还把殡仪馆给捧红了。人生中的最后一件事。
guyikun琨琨琨 : 回复@海水之女:义正言辞的放屁
造型师陈丹 : 自杀对父母来说就是不孝，他练自己的父母都不考虑，连中华民族最重要的传统美德都没有去遵守，有什么值得人们缅怀的？
想到了再起 : 回复@张05153:滚
自带蓝红buff : 回复@2Bpencils:哗众取宠的公众号
-turtlescanfly- : [蜡烛][祈祷]
jiji-晶晶 : 回复@寂年华:哎呦…了不得唉…看你的评论你的素质也不咋地…一个连一个不会尊重人的你有女朋友，你的女友是有多委屈啊！ 别什么戏子的说死者。我也不是什么追星！他们除去演绎人员的外衣就是一个普通人，和你我一样的普通，和世人一样普通，和你所谓的有素质有朋友一样有素质！
半是蜜糖__ : 新浪娱乐的署名还能再大点吗！！！！！
杏福白羊仔 : 回复@芝士味的少女婷:你才智障呢[鄙视]
凝萌婼娜 : 回复@隔壁王永亮:喷子，你走开，你不说话，也没人踩你，就算是说话，你也是乌鸦
河东知府 : 冬天花败 ，春暖花开， 有人离去， 有人归来。生命，每个人只有一次，或长或短；生活，每个人都在继续，或悲或欢；人生，每个人都在旅途，或起或伏。一路走好，老乔，如有来世，你投胎做个普通人吧，乔爸妈也节哀保重身体
Ada乔忆惜 : 很伤心 再也见不到你了 永远离开我们了 真心心疼你 不知道这么几年你是怎么过来的 [泪][泪][泪]一路走好 好好休息
你好校内2011在江湖 : 在世的时候为什么不能多些宽容
寂年华 : 回复@jiji-晶晶:哥有女朋友，一个有素质有内涵的女孩
已经是个老骚年 : 他是谁？
_林小林- : 看着挺心疼
linxiaohong002 : 已撸走好，上帝会照顾帅哥美女的。
成都理工大学传艺院h_O : 可怜的孩子，我不是你的粉丝，但我听到这条消息，也忍不住流下眼泪
20888m敏 : [蜡烛][蜡烛][蜡烛][蜡烛][蜡烛]
Remember_daring : 回复@隔壁王永亮:任何人以这样子的方式离开都会让人惋惜，你说这话的时候，又和网上的喷子有什么区别，逝者为大，请注意语言的杀伤力，哦对了我不是粉，我只是路人[微笑]
吉祥麻麻嘤嘤嘤 : 再一次的走好！
睡不着森林 : 为什么一定要称呼其为kimi，人家没有中文名字吗。 祝乔任梁一路走好[蜡烛][蜡烛][蜡烛]
你是我在等待的未来zxy : 回复@嘀嘀叭叭xx:我也是你们感觉的
Tel_大脑袋瓜 : 人固有一死，或轻于鸿毛，或重于泰山
NIXKANG : [泪]
董小姐鼓楼的夜晚时间匆匆 : 呵呵。还新浪娱乐   真是好笑
手机用户3098722945 : [蜡烛][蜡烛][蜡烛][蜡烛]
jiji-晶晶 : 回复@寂年华:这注定不会被尊重…注定孤独终生！
jiji-晶晶 : 回复@寂年华:对你这种小孩连尊重都不懂，三观有问题，就是欠教育的！看来你是被甩的次数太多！人丑多作怪、嫉妒，真不知道你受得是什么教育！
别把我当凳子骑 : 也不知道自己为什么哭，长得丑的，你们会哭？
屗肆 : [蜡烛][蜡烛]
菜菜12085 : 一路走好，愿天堂里永远都有好心情
早已不是爱 : 新浪娱乐，去死。只知宣传赚钱。
mo-chengjing : [蜡烛][蜡烛][蜡烛]
掩2盗0 : 王俊凯
轩墨水清summer : 少一些炮轰、多一些关爱、也许悲剧就不会发生
墨云朵c : 那么年轻，真的好可惜～直至今日依旧没法相信～[泪][泪][泪][泪][泪][泪]
杨辰洺 : 铠甲勇士都来了
海水之女 : 回复@海水之女:接上条，2. 其他人只能呵呵，你们说乔被喷死，转头就变成喷子？有人私信问我为什么不删，措辞已改，心意已表，问心无愧，为何要删？留着让大家看看正邪。至于那些说存在感的，站在道德制高点的？你们一定要把人往坏了想那也没办法了。发被喷，不发也被喷，怎么样都被喷。最后感谢真心的探讨和指正。
海水之女 : 回复@海水之女:总结一下，1.当时考虑大师都是上世纪二三十年代多，故用戏子作为职业对比，没有轻蔑之意，留言也仅是表达希望媒体多关注各个领域之意，对粉丝并无不敬。意识到后立刻追加评论更正并道歉，然而被热血粉丝和某些喷子淹没了，晚些时候我再一次追加留言说明情况，再次被淹。真爱粉我理解。其他人只能呵呵。
Y小耶 : 愿逝者安息。
小旭zi : 你只是暂时离开，你还会回来[泪]
林想念呦 : 回复@海水之女:你是在博关注还是键盘手？
大饼_则卷 : 对于一个爱名利，比爱生命更多的人，从来不值得被可怜，
