观相读心_摄影师长空 : 川普是委婉的正义和强势，希拉里纯粹骗子、罪犯。
jack1x1 : [哈哈]
隐士徐庶 : 这损川普有点过分[汗]
李综容 : 回复@李综容:一个骗子一个小偷[眼泪]
李综容 : 一个骗子一个小偷
诗姐计划美好人生 : @诗姐八美国政治: 这个段子很幽默，希拉里的桥段是骗骗三岁小孩和政治正确的自由主义者就可以。她一直生活在克林顿的名气和政治光环之下，身边的人因为他们的权力而得到好处，把她捧成女皇；她出来行走一下江湖，保证五分钟之内被川普搞定，期待他们的一对一辩论。
诗姐八美国政治 : 这个段子很幽默，希拉里的桥段是骗骗三岁小孩和政治正确的自由主义者就可以。她一直生活在克林顿的名气和政治光环之下，身边的人因为他们的权力而得到好处，把她捧成女皇；她出来行一走一下江湖，保证五分钟之内被川普搞定，期待他们的一对一辩论。
du12345du : 厉害
大连老邓V5 : Pu……
昊天金阙无上至尊上帝 : 转行当段子手了[嘻嘻]
亥刀金艮 : 老骥伏枥，志在千里！不怕，为了美利坚！[haha][向右][美国]，药药切可闹～耶啊～[哈哈][haha]
jim_chong : 川普70，却是个口无遮拦的玩皮小青年；希婆69，是个要权不要命，迟早还是摔一胶的政治动物
因你而不同1 : 会不会在工作岗位上挂了？
summery_zhao : 小平同志也不是70岁出来工作，把中国搞的很好，
秦汉雄风在 : 在中国，这是下台的年纪了。
无所谓了的阿惟 : 千万别在任期狗带。不是嘲讽，是真心...
百分支9十九 : 回复@Kapitaen-Schild:不要老想搞个大新闻[挖鼻]
Kapitaen-Schild : 没到九十岁也敢称老人，长者表示是时候教你们一些人生呢个的经验了。。。。。
啦计技术 : 特不一定干的淫希，原因是女人没那么容易就满足的，男人么很快的大家都懂，呵呵呵呵呵呵呵
联邦中囯参议员---盛夏_阴雨天 : 特朗普看起来像40多
帝国斜阳007 : 回复@西安董冬:[哈哈]
西安董冬 : 回复@帝国斜阳007:知道。纯属玩笑[笑cry][笑cry]
帝国斜阳007 : 回复@西安董冬:他好像没这个权力[NO]
西安董冬 : 奥巴马赶紧修宪[笑cry][笑cry]
寶樹零叁柒肆 : 我一直以为希拉里比他得年轻10岁左右
门钉肉饼妞 : 这年纪应该好好享受生活
云在花都 : 看来老美已经日薄西山了，快后继无人了，现在一代比一代差了
bj花生 : 美国总统居然也是老龄化严重啊！
livol2536 : 老人？他，笑了~~~
夏天真的在海边 : 里根当总统时居然都比他们年轻？
埋了的说客影子 : [笑cry]我看是比谁死在选举路上。
石城傻瓜 : 在西方搞政治并不是值得尊敬的事，可这两人为嘛还要不顾年高体弱来拼命呢？为名？为利？为国？为党？为公？为私？我不是美国人，无法用中国人固有的思维来考虑这事。美国不是最好的，中国更不是老中医包治百病。
taosiping : 资本主义已日薄西山，气息奄奄，后继乏人。
霸虎战神 : [吐][吐][吐][吐][吐][吐][吐][吐]
黄袍加身宋太祖 : 希拉里可以拼年龄，特朗普可以拼健康，反正就这俩人，瘸子里面选……瘸子……
蛋疼客 : 美帝领导人人才培养出了大问题
sasalor007 : 两个老人在吵架！女的希望这个金山阿伯快点去世，把身家贡献出来给新移民福利。然后就可以对美国人说，这个社会的爱很多。可是，有人想过这个阿伯是被气死的吗？
熟袽陌璐 : 不是七上八下吗
蚊子的听觉 : 小平复出时七十多了吧，还是开创了新时代
谍影发发 : （-。-） 都到了家里堆满保健品的年龄了。
南海客人 : 我敢肯定，肯定有一“子”当选下届美国总统！不是“骗子”就是“疯子”！！！
天枰座小清 : 这2个人都不是什么好人！女的就跟令人讨厌
FrostWings : 一个身体状况不好，一个脑子有病。。。于是奥巴马的支持率一年内一直在增……
Johnnnnnnn : 邓总设计师快90还南巡呢
跪安 : 等他俩活到90岁再称老人吧
王黼锐哥哥 : 先定一个小目标：先挣他一个亿
yukamomo : 心疼希拉里，不是你的终究得不到？！
Sunshine_醉 : @袁小绿绿绿_Taec
一捆青菜 : 转发微博
乙乙乙乙乙乙乙乙 : 天！这哪里只是肺炎啊！这病的相当严重了哦！
奋斗中的Jaga : @噢不我要两杯奶茶
MisterLLLL : 雪上加霜
souffle08 : 回复@兔白糖:希拉里上我帝就是伊斯兰强国了
好运围绕跟斗身边 : 可以提前恭喜川普了
黄圈圈猫猫 : 会不会是一个坑？
所有的西西 : 回复@慕清欢:[失望][失望]
nonobra123 : 这个角度更清楚，她真的不行了
造钢牙的麒麟子 : 回复@_momomua:这么为了副总统，是不是应该深扒下是哪位有背景的娃
_momomua : 回复@造钢牙的麒麟子:应该把注意力放在副总统身上了吧...
Angelafucking : 回复@Miss榴莲忘返:我感觉相反
重奖绝缘体的宝宝 : 我还以为拉走接受调查去了
_Sgirl : 是中风了吧？
小象头上长了个长颈鹿 : 卧槽 川普当总统 这个世界就不会好了
夏威夷_海 : @Kobeistheman
亥刀金艮 : 这个角度，细看，站不住，迈不动腿，几乎是被架起来拖进车里的。
亥刀金艮 : 肺炎能废成这样？
雾蒙蒙随风而逝2010 : 她看着像是中风了
兔白糖 : 川普不会就此获胜了吧[惊恐]，世界强国，再见[拜拜][拜拜][拜拜]
十一月的XB : 张绍刚：你是在表演吗？
荒唐的凑个热闹 : @不知道何时就喝下了一盆鸡汤
滿滿滿滿滿正能量 : 这女人 真的太拼太拼了……
西一噢小波噢宝波欸贝儿 : 我怎么觉得这是为败选铺台阶呢[挖鼻]。不是说就一定赢不了，就是为将来留个台阶。。。
阿连球儿长锅 : 就这身板，中国欢迎这样的人当总统!
在变坏的Jimmy : @我还是喜欢LYZ
丁幼蕾 : 回复@CHUX-:我觉得希拉里很适合当美帝
想改个名字但不知道改什么好 : [笑cry]911纪念会后昏倒
per--sempre : 哎，没办法，民主党没人了……民主党应该觉得希拉里只要选上了就好了，反正都是党的胜利
野牛之爱 : 这样玩命，副总统候选人笑了
shawntzzy : 川普真的要赢在健康了==
超多徐 : @StarCrossedLovers 非常严重的症状了我感觉
4AF- : 整个安保和助理团队让我想到了veep……期待veep第五季！！
KevinSong : 这个角度更清楚，情况相当不妙啊！团队也相当不负责，现场就应该躺下等担架上救护车，权力真是害人！@空耳同传君 
荧光双树 : 回复@王嘟嚕咕嚕:哈哈哈哈我也是[笑cry][笑cry]要变
洱海以东 : @PAM_ZHZH 她应该是中风了（stroke）
进击无敌刘小毛 : Repost 
wazg1234 : 为了川普当选，玩命了
Miss榴莲忘返 : 希拉里如果做总统了，中美关系应该更紧张了吧？？？
usd125467u : 转移话题
栗子烧R : 回复@-Eva是依依小玮-:好可怕。。。。。太拼了简直。。。。
浮萍5314 : 鹬蚌相争渔翁得利 希拉里会指派谁为未来总统呐 期待
CHUX- : 大美兴，川普王
muuu_chelle : 死活不让sanders上，自己又这样。。。真是气死人了
G_Shan : 妈的 川普要当总统了 我刚来美国啊 呵呵了
魔女之夜lyra : 本来老太太上台也够麻烦的了
文星大曲 : [吃惊]鞋都掉了
白雪皇后yanni : 这么花多少钱啊，雇这么多保镖，好怕出内鬼
我是小弱鸡啊 : 希拉里一天天事这么多
何東阳洋 : 大青果药丸
_土_土__ : @小碗炒面不要酱油
DC玩疯了 : @21号邓呆呆
Angel如影随形 : 身体都软弱无力了，站都站不稳，美国人民的眼镜都被屎糊住了吗
菊轩家有小豆包儿 : 老太太肯定不是肺炎…
造钢牙的麒麟子 : @_momomua 果然跟保安手里的癫痫针对上了
临江仙小甲鱼 : 天佑川普的节奏？希拉里的身体看来连熬到11月大选都难了
王嘟嚕咕嚕 : 刚看完《釜山行》 丧尸片… 感觉好熟悉的动作
造钢牙的麒麟子 : 这么拼这是要造福副总统阿[偷笑]
吕淑玉说她要么pass要么死 : 身体不行就别作妖了[微笑]
锈蚀的世界吱嘎吱嘎 : pneumonia 能这样？[doge] 临床的小伙伴们答一下～
再见蛋糕喵 : 感觉不像肺炎虚弱无力那种啊，开始那两下一颠一颠的还是好像癫痫，后面被保全人员挡上了不知道是不是开始抽搐了[doge]
蜉蝣于朝暮 : 那几个保安故作镇定的表情配上手忙脚乱的动作[眼泪]
白雪皇后yanni : 身体不行，当总统又是个大障碍了
泉音_ : 太拼了
爱纸箱和Arashi的SFC_AL闫 : 在想debate 的时候站那么久怎么办
刘十九cs : 演技派
破折YY : 这样岂不是无法胜任总统一职？身体问题可是大问题啊
热心市民周女士 : cnn报道竞选团队说她是肺炎，鬼信……
-Eva是依依小玮- : @栗子烧R 恐怖
-Eva是依依小玮- : @梁布拉多--
财务人儿爱梗犬 : @苏九为
宋鸢 : 电脑刚弹出新闻推送。说是周五已经诊断出肺炎了。同时提到trump已经连续几个月质疑希拉里身体状况是否能胜任总统职位。trump这次反应平静（restrained）不过米国人大概会开始觉得希太虚弱了吧 
费庆毅 : @徐闹闹-_
童子非 : 中风？
sober高邦 : 感觉川普真要当政了。。
用茶杯泡咖啡 : 又一个蔡英文？
略显忧伤的TonyChan : 身体不行就别竞选啊 害人呢
