等不到天黑烟火依然太完美 : 愿你下辈子做个普通人。享受平凡的生活～[太开心]
小淘气妈咪小窝 : 回复@四夕妍:这么阳光的他怎么会不在世上了[泪]
厚控shine-zxm : 回复@守厚星路路HCY:是啊，看他的微博，看到更多的是他的笑容，虽然痞痞的，却显得那么的孤寂[泪]，又有谁曾真正的了解过他的内心的苦？可是他真的不该选择这么极端的方式结束自己的生命。也许这样，他真的可以休息，可以解脱了[泪][泪][泪]
冰儿大人 : 谢谢你来过，喜欢看你这样笑
星座秘语-占星师Mabel :  [cc歌唱] 
SHINee_JUN_K唯一 : 如果他可以看到这么美好的自己，他会不会也不舍得离开啊[悲伤]
Mrs_童心未泯 : 看着看着眼泪就下来了，总觉得你还在～那么阳光，那么温暖，嘴角扬起坏坏的微笑～[祈祷][蜡烛]
海宝乖乖520 : 这么好看的笑容[泪][泪]
我是梵西 : 你的青春永垂不朽……
我是梵西 : 你的青春永垂不朽……
鲅鱼圈女子 : [蜡烛][蜡烛][蜡烛][蜡烛][蜡烛]
娜酱紫 : 这么帅[悲伤]
千智荷 : kimi的脸上永远挂着笑容，小虎牙笑的时候总会露出来，感觉你一直离我很近，接受不了你的离开，真希望一切都是假象，kimi天堂没有烦恼，可以做自己喜欢的音乐，唱自己喜欢的歌，天堂的你会是你自己想要的样子
坐在云端的雪 : [蜡烛]
v夜xiao明v : 转发微博
柒小慶 : 那么阳光。怎么舍得。  好害怕乔恩看见，眼泪会止不住的流。[泪][泪]
Zhang-Linyue : @Da张小吖
大鹏展翅程长中 :  [bofu变脸] 
金光闪闪大淑女 : 对不起，爱晚了。
Z-ChenXin- : 走好[蜡烛][泪]
英姿飒小爽 :  最新[km问号]资源 
GDRAGON_LAY : 大家都说走好 可是 我想说不要走
娜就陪你炅下去_HX : 阳光大男孩，我们永远记得你。[心][蜡烛]
是啊我就是那株木棉啊 : 阳光男孩[蜡烛][蜡烛]
艾陌七 : 是我爱晚了
Sylencq : 一开始不了解，为什么会因为外界难听的声音为难自己，让自己过得痛苦不安；现在慢慢明白因为不是当事人，所以没办法站在他的角度，感受他的感受，所以不能够真正理解，更没资格去评判他的情绪。
蓝色的思念sn : 太可惜了
高小力_Iris : @一大头蔡 好帅呀
庭外海棠依旧 : 回忆中的你都是笑脸
果意吴 : 真实可靠       免费入职 
大象小姐s : 这段时间、你让我感触很大很大！ 年轻与寿命之间…… 姨婆离开我四年，我依然感到她就在我身边没有离开过！ 永不见跟不能见，我就当做一个道理！
慧灬姐 : 回复@AngeL-宁-:这回看见了
晴天那是你的声音 : 哎
女王范儿小怡 : 太帅了。好阳光。舍不得
流冰寒光 :  [bm内涵] 
守厚星路路HCY : 回复@厚控shine-zxm:明星好多外表光鲜亮丽，内心却很孤独，所以对明星好的坏的都不要去批判，每个人都有自己的迫不得已！我们要学会去谅解！[悲伤][悲伤]只是为什么他要这么极端，傻孩子，自己得多难受承受这些！[悲伤]
英姿飒小爽 :  最新[cai羞羞]资源 
几味丶老友 : 回复@nnbae:我就跑来问咋地了，我问你了吗？
酒小护 : 从此再也看不到你坏坏的笑了[悲伤][悲伤][悲伤]
李菇凉是神经病 : 虽然不是他的粉，但是真的有被惊的，一点也不相信他就这么走了，可惜了
筱樱的夏天 :  最新[调戏]资源 
korea雅 : 舍不得
我的王懵懵举世无双 : 下辈子做一个最快乐的普通人[祈祷][蜡烛]
苦瓜臭疍 : @防硬年 真的好遗憾 [悲伤][悲伤][悲伤]这样的少年离开了
DareToDreamTo : 还是不敢相信。。。[鲜花]
亞晨z :  [ala得意] 
亞晨z :  [ala得意] 
0于淑君0 : 美好的像画 真的变成画了
阿阿花_ : 离别的秋.. 
孔乞杂孔 : [害羞][雪人]晓驹霄班莉桂翀之驹 
我漂亮的小珂珂宝宝 : 我一直觉得很奇怪，有虎牙的男生外带着邪邪的笑一定会红，谁知道其他的人都红得发紫，而他却去世了……一活一世真是天时地利人和的合作……当年的好男儿是真正的纯天然无污染无添加高颜值，现在的人造花美男怎么比哦？哎……斯人已去……
沉默的门卫 : 为什么没有个遗书呢，难道就按他在知乎里写的那样做？
AngeL-宁- : @慧灬姐 帅炸了
叨叨吕 : 这么阳光这么帅，如此温暖的笑，太可惜了。哎......[泪][泪]
黄黄黄_小珊 : [心]
CAIQING1227 : 一周了还没接受这个消息
CAIQING1227 : zouhao
英姿飒小爽 :  最新[熊猫]资源 
思洁北鼻 : [蜡烛]願天堂沒有痛苦
哆_琳_YangMiRin : 真的好好看
韩赵佳颜 : 走好了kimi。。。[祈祷][祈祷][祈祷]
Eillen_R : kimi一路走好
钟情却不终情-W : 我想去找你
菜子小姐 : @宇宙无敌小八
小太阳要大晴天 : [蜡烛][蜡烛][蜡烛]
Yana-Lele : 长得帅，也不算没特色。唱歌好听，还会弹吉他。才华满分。努力也有回报，就是把不好的事，刻薄的人，放大放大。才会酿成今日之祸。诶太可惜。应该坚持一下的。等到好的时机，一次公关，一个小举动。说什么也无用功。走好。也希望大家能善待他人，减少网络暴力。
hello蘑菇 : 愿你被另一个世界温柔以待
rose94doris : Repost 
正义的陈宜 : 诽夜献叶鹿   
理想国FUN : 还是不能相信[悲伤]
筱樱的夏天 :  最新[km热]资源 
涯语风 : 没法想象他老的时候的样子。所以老天让他安静的去了也许是最好的安排。一路好走[蜡烛]
四面八方都是你啊 : 好舍不得
M鹿M-LY : 真的很好啊看，会出吗
程锂 : [蜡烛]下辈子做个让自己开心的人就好
慢慢慢慢慢慢慢慢- : 再也不会遇见第二个你
黄小笑笑2011 : 仿佛认识你就像是做了一场梦，你走了，梦醒了。。。
-七七77- : [心]走好
当之无愧小胖妞 : 内心要有多大的压力才会选择这种解决办法离开爱你的家人朋友以及这个美丽世界。并不追星，但是看微博这些关于你还是泪崩了.愿你被那个粉红世界温柔相待，没有舆论，是非，压力。
迷路精靈- : 人已死何必拿来说话，活着的时候谁给予了他阳光？
小柔Cc : 没把米的个人鲜明特色拍出来，他多有魅力了。。这太格式化了。。像韩国范儿。。烧一本给米啊。。
耗子扛刀满街找猫m : 不敢相信，[大哭]
北纬45度的阳光- : 好帅啊
MINILR : 我最近在看一个剧，有一个演员很像你，所以总会想起你，鼻子很酸。。。
Mr-發瘋 : 原来不是叫任桥梁啊[打脸]
FreeSk8 : 帅的老天都嫉妒
AbnormalRabbit : @落尐北
kim猫饭花_99 : 我也总觉得他还活着被这个消息冲击了一周都没缓过来。。。
心里住着一颗小太阳 : 细心体贴善良有爱心的，笑起来温暖阳光的，工作认真的大男孩儿Kimi，愿你在最接近阳光的地方，全是你喜爱的粉红色，唱自己爱唱的歌，做自己爱做的事,一切都好！[蜡烛][悲伤][太阳] #送别乔任梁#
CClunch浪的飞起 : 明明你的眼神那么充满希望
正义的陈宜 : 踊卫志亩池   
遥知兮兰cln : 人生太无常，前一秒还是个充满生机与希望的阳光帅小伙，下一秒就成了一把灰随风而去，这个世上再也没有这个人
aling宝宝 : 眼睛没什么神彩
媛宝媛宝NO傲娇 : 我想他
Gloomy韵 : 不，还是没办法接受这个事实，不敢相信[拜拜][拜拜]
爱吃糖醋鱼的一棵菜 : 到此刻都还不相信你已离开我们了
英姿飒小爽 :  最新[cai怕羞]资源 
庞晶丹 : 回复@Jiang知了:[心]
enidjia : 这么美好的一个人就这么走了。。。
Miss-Phyllis : 求老天不要收你，把你重新打回人间，你可以不演电影，电视剧，不上综艺节目，只要能回来，健健康康，快快乐乐的就好！
黄鲸鱼咯 : 转发微博
黄鲸鱼咯 : 转发微博
candy婕513 : 一路走好，天堂没有流言蜚语，来世愿做你的VIP，愿你在那个粉红色的世界里永远幸福快乐！
游走在世界的冰激凌姑娘 : 好帅气的面庞，希望在那里一切都好
爱喝奶茶的粽子 : 额 你确定他没看到过 
冯莎娜 : 看起来就好温暖
我叫林倩莹- : 那么爱笑的你 怎么会想到和抑郁挂钩呢~
_Hailie_piu : 我知道 这个夏天 就像你一样回不来 我不会再对谁满怀期待 一路走好 kimi[蜡烛][泪]
守护乔kimi等你回来 : 每天下班回家，第一件事情，听着乔唱的歌曲！循环播放，眼泪不由自主的落下～是你陪我走过这十年！[蜡烛][蜡烛][蜡烛]
筱樱的夏天 :  最新[哎呦熊害羞]资源 
亲爱的laura : 其实我都不算他的路人粉，可是今天却哭了好几次，我想我们心疼的是公众面前阳光乐观的他心底浓郁得划不开的悲伤
Apeirou_H :  [抽耳光] 
快看这里有大象 : 多好的男孩啊，，，世界上再也没有这个男孩了
夏目未闻花名Z : [鲜花][鲜花][心][心]
钰钰钰姝子 : 回复@AAmygalaxy:看他这么阳光的一面 谁会想到会因抑郁症自杀
梦奇奇-2 : [蜡烛]愿这支蜡烛能陪你走过黑暗，带来一点点光明[悲伤]
我是温馨- : [蜡烛][蜡烛][蜡烛]
Jiang知了 : 回复@庞晶丹:我又哭了一轮了[悲伤]
小柠檬树啊 : 路人粉的我今天晚上都难过的哭了[悲伤]那么阳光的大男孩，他的粉丝和朋友得多难受啊。
Shirley秋-起风啦 : 走好[蜡烛]
腐女余卓 : 孜臼菇   
yuan以梦为马 : 现在只要看到他的照片就忍不住想哭
kaililu_lu : 觉得你没走
Sining鱼鱼妹妹 : 这么好看的男孩子。。
橙子家的宅宅 : 他真好看啊，kimi，可我甚至不敢点赞不敢转发，怕多年之后慢慢释怀却又在偶然看到的时候哭出声。
都叫小胖了还能怎样 : 回复@ZZ__1991vip:[心]
ZZ李 : @绝版大毛儿 哪里看得出来那么严重的抑郁症，心里不知道好痛苦还要这样笑
那我先吃了 : 回复@圈圈Iverson:我不知道他九年前是什么样子的，但是我看到这组的时候也觉得好好看
傻缺麻麻驾到 : 每一张都能让我心如刀割…[悲伤][悲伤][悲伤]
動次動次_Moni : 不知道为何，就觉得你没走。毕竟我也是个追星的人，从好男儿开始注意到你，你是所有男孩儿中最叛逆、最有个性、最吸引人的一个#送别乔任梁#  一路走好，你的天堂永远是粉红色的[蜡烛][蜡烛][蜡烛]
-然然兒 : 有的人言论完一个人，也许会继续不痛不痒的人的言论下一个人，其实人言还是可畏的。
麋鹿女皇 : 真的很帅，愿你一路走好[蜡烛]
小马巴斯 : 我从来不追星，但是这样阳光的大男孩，真的太可惜了
一个冰琪琳球球 : 明明是那么干净，阳光，又美好！[可爱][可爱]
小剩女的春天 : 失恋第二十二天，空气凉，不用穿秋裤  头疼，差点又迟到，昨晚和闺密喝的烂醉，找不到北了，还好是在她家，要不就糗大了[抓狂][抓狂][抓狂]  男士们告诉我你们醉了以后会失忆吗？我怎么也回忆不起昨晚都干吗了，还好没有吐的闺密家，要不多尴尬啊！抱歉抱歉 刘宝宝   改天再去陪醉了[嘻嘻][嘻嘻] 
喝了苦瓜汁感觉萌萌哒Miao : 一路走好[蜡烛]
加肥喵-Seamus : 这个嘴角时常带着一抹坏笑的男孩走得既心酸又骄傲. 有时候你以为是毫无征兆，其实他已经挣扎的精疲力尽...在这个充满了辛苦的世界，多关爱身边的人吧！
晨羽翼 : 祝好[心]
司各特路137号 : 难过
司各特路137号 : 难过
范俨媛 :  [悲剧] 
紫色--purple : 回复@quite_MAO:[心][心][悲伤]
-星咩- : 晚上在梦里相见吧
木三木三3 : 大概还是没有想通为什么要离开 怎么就离开了
wryioppjiurfv123suojfrtuiggcc : 向往的美好
nini789_35134 : [泪][泪][泪][泪][泪]
佑果儿酱 : 我跟我老公都不是他的粉，我两也从不追星，但都觉得太可惜，很有魅力的一个人，就这么走了
少女啊可否把心还我 : 前一段时间还看了我们的十年  那个笑起来总是灿烂的翩翩少年 粉色天堂应该很美 他才走的那么着急吧[伤心]
谁的爱上一个人789 : 我愿你在那个世界没有烦恼
谁的爱上一个人789 : 我愿你在那个世界没有烦恼
英姿飒小爽 :  最新[钻戒]资源 
Luvvy璐璐 : @姐姐小脑发达的很
微尘_PXX : 来不及看的写真，太美！
江莉蓉520 : 好舍不得。。
Yang_小小小靜 : 走了，走了，是真的走了[伤心]
神不隆冬sbld : 一个为国家作出巨大贡献的导弹专家去世几天都无人知晓，一个二线演员得忧郁症自杀而亡，腾讯微博天天登头条，建议为这位演员降国旗 .
腐女余卓 : 涛自翘   
把你写进歌里面 : 看评论说那么美好却已不在 哎 这世间就是有太多的遗憾 愿你在那边安好[悲伤]
叶夜月孰美 :  [lxhx喵] 
