小孩纸是小豆豆10 : 认真的专注一件事肯定可以的！！！！[好棒][好棒][好棒][好棒][好棒][好棒][好棒][不好意思][不好意思][不好意思][不好意思]
分裂患者_CRS : 惊动BBC……我还是觉得惊动央视比较实在，因为中国的美食只有中国人能懂他的精髓所在，毕竟都是吃了十几年几十年的中国菜知道什么样的口感最适合中国人，外国人惊动了也不能懂我们的那种情节，可能还会觉得我们的小作坊不卫生，可就是这样的环境才有那种说不出的“味道”
哦哦哦哦哦哦哦哦小心 : @sisimer 来个饼可好
長安Vivian : 腰都弯了[心]
花前月下对影成双 : 回复@涅瑟唔了:在哪儿的[开心]
君大大吖i : 图片评论 
郭凯琦 : 回复@青菜青菜快走开:如果是上交这个还差不多
HH-XINXIN : 回复@睖妹子:不能更同意了！！我觉得我老家最土的哪种月饼是最好吃的 商场里包装越好看越贵的月饼越难吃[doge]
HARUAKI-C : 绝对好吃
欧阳和木朵 : 老伯记得保护好自己的腰
欧阳和木朵 : 老伯记得保护好自己的腰
记忘不纠 : 我想知道在哪儿[馋嘴][馋嘴][馋嘴]
他们说查无此人 : 喜欢的[花痴]
无奈每一深宵又记起你 : 一丝不苟的神情令人动容
弹指间94508 : 这是传承
Yoyo四海为家 : 想起了泰囧里面的宝宝
中国新闻网 : 【老味道无关卖相，而是一种情怀[心]】@鹿饮溪在：已经闻到葱花香了；@睖妹子：这种最实在的、直接看得到、闻得到才是真美味；@谢悦xy：一生做好一件事足矣；@lee阿聪：工匠精神，希望传承；@涅瑟唔了：吃过，排队3小时，还是站着 [doge]
得誠峸铖珹絾城 : 看着就很好吃[色]
那一对飞过沧海桑田的蝴蝶 : 回复@咸鱼菲otato:再见！
小小小小五不会飞 : @陈凯文铜學 我想吃一回
那一对飞过沧海桑田的蝴蝶 : 回复@咸鱼菲otato:再见！
小小小小五不会飞 : @陈凯文铜學 我想吃一回
HLzo_O : 这个看起有点好吃
北腿爷爷_135 : 回复@precious_time_Zzz:具体在哪天路上，我也想去拜会下
箢得 : 匠人精神[good][good][good]
不靠谱的教书匠 : 就是锅魁吧
林小白z_ : 好饿[委屈]
大头大宝_02 : 中国味道
xienan77124 : 看上去好好吃。师傅你收徒弟吗？
猫先生_LJ : 惊动BBC  吐了  能不用这么土的朋友圈标题吗  这集看过了 看起来没啥食欲  不过人挺多 应该不错的
猫先生_LJ : 惊动BBC  吐了  能不用这么土的朋友圈标题吗  这集看过了 看起来没啥食欲  不过人挺多 应该不错的
哆啦啦000 : 背驼的好严重
money潘 : 为老伯点[赞]
芹菜家家 : 千言万语汇成一句话，俺想吃[色]
糸工丹三丹三 : 不知为啥 看着就像其貌不扬味道惊人的那种丑样
_Chiaraaaaa : 都驼背了，这种匠心
二十四岁的羊小姐 : 360行行行出状元。只要用心，都能在自己的行业做出彩。
赵一璇赵一璇 : @换换换换sa
precious_time_Zzz : 有年寒冬腊月，工作日排了两个多小时的才买到[拜拜]
MissVIP_Sally : 好想吃[good][色]
顧M7hhh : 这个很多年以前上过人气美食的 真的很火
鱼丸面木有碗 : 老上海的葱油饼，那种味道真的不能忘
-三生有幸被你回应 : @-三生有幸能喜欢你 我靠我想吃
evil的居士08256 : 老手艺的东西不仅好吃，而且感觉有一种历史的沉淀，能使人回味！
夜礼服的猫 : 看起来很好吃的样子。酒香不怕巷子深啊
挥袖风飘 : 油炸饼不喜欢，喜欢烤饼
美美的Metis : 回复@cccccccccccllllllllllll:求地址……
-At-Will- : @KKKKirito 很出名的感觉   不知道在哪   有机会去试试呀
你蓝牙没关 : @讲点给你笑笑_miao
对心直动滚子推杆盘形凸轮机构 : 回复@一人的旅路:你这话我不同意，北京胡同里的工匠，不少，只是缺少发现工匠精神的眼睛
你蓝牙没关 : @讲点给你笑笑_miao
对心直动滚子推杆盘形凸轮机构 : 回复@一人的旅路:你这话我不同意，北京胡同里的工匠，不少，只是缺少发现工匠精神的眼睛
爷是需要正能量的俏怪兽 : 茂名南路159弄2号后门(近南昌路)@沙罗双树下的弦术师  有机会去吃这个[色]
張芭樂er : @汤汤汤汤汤哲
陈柏融的笑容我来守护 : 去吃去吃[害羞]@中国新闻网:【拿走不谢！ 阿大葱油饼的地址来啦[鼓掌]】三十多年的葱油饼， 一辈子的上海味。“阿大葱油饼”位于茂名南路南昌路路口。葱油饼5元一只，每人限购10只，而多数排队的吃货都会选择“顶格申购”买10只。想吃的，赶紧排队啊！[馋嘴]
其实我是西瓜瓤x : @其实我是葡萄
馨雨坤梦 : 如果我的城市有，我肯定去买[泪]
Garfieldhoho : 阿大好红…
23画嘿嘿嘿 : 工匠精神
23画嘿嘿嘿 : 工匠精神
我真是哔了歌莉娅了 : 老字号什么的最吸引人了[doge]
Blingbling覃开心 : 好想吃啊
梦也山庄33 : 一个人一生那怕只做一件事、只要做专一了就是最棒的，老伯把平凡的事做成了全国人民事都知道了的事，称作为事业不为过吧？
蜜雪仙粉黛 : 一定好吃[good]
sunnyee__ : @鱼小主za 第二次看到了 你们去吃啊
武汉陈国恩 : 葱油饼确实好吃！[嘻嘻]
无言的结局22462 : 这种老手艺一定要保留
LINI未里 : 在哪裡？我也啥時候上海尋覓去[馋嘴]
打水娃 : 隔着屏幕都闻见香味了[馋嘴][馋嘴][馋嘴]
幸福的流言 : 莫名的感动
-南方姑娘bigbeauty : 回复@cccccccccccllllllllllll:我也好想吃
刘大美-- : @你好老白 啥时候带我去吃
白羊座的猫猫 : 看饿了
喂__小番茄 : 回复@-铁锤妹妹:想吃
用户6027598987 : 太好吃了
我跟亲妈的日常 : @暴走的萝莉君- @猴星少女 [害羞]
健康美食艺术 : 好吃好吃好吃
yongyongyongyong7 : 敬业
朱来大猫 : 《上海味道》
cccccccccccllllllllllll : 回复@-南方姑娘bigbeauty:真的好吃，我那天从早上十点排队到晚上四点………
阿拉步啪腻 : 城管表示要去吃一回[doge]
崽崽崽崽哥儿 : 好想次[色]
桔梗应未央 : 这个我路过 看到好多人排队 当时还看了一眼 发现是买葱油饼的 当时特别不能理解 原来是家老店啊 [赞]
Wishyoueverysuccess : 貌似不错嘛
--Dew : @Angerleaon 下次去吃
蒋吹吹 : 回复@晚上木有吃午饭:看过
白小鱼de爱情 : 葱油饼超好吃的
朴灿烈kkkkkk : 他妈神烦评论不干净的买相差的
白小鱼de爱情 : 葱油饼超好吃的
朴灿烈kkkkkk : 他妈神烦评论不干净的买相差的
征服天下520520 : 烧饼也卖这么火，什么时候我也改买烧饼得了
对口哨没有抵抗力的狗带少年 : [挖鼻]真的很好吃
杰哥我是你的小星星啊 : 想吃[馋嘴]
eLApseeee : @P那个z 想吃
Jz不算是昵称吧 : 想吃学校的葱油饼了
筱筱琛 : 这个老板曾经去泰国旅游，然后在飞机上遇到了一个叫徐朗的光头……
白小鱼de爱情 : 超级喜欢吃葱油饼[笑哈哈][笑哈哈][笑哈哈]也不知道这个爷爷在哪个位置 想去吃
floccinaucinihilipipificationc : 回复@和大仁:你说的哦
大航爱笑爱生活 : 上海哪里
说吃胖很难 : 在哪里啊
YES-LSN : 回复@一人的旅路:我不是上海人也不是北京人… 但你夸上海还要踩一脚北京实在没意思了…
王华华华华华华 : @newstarrr 感觉好好次，你去试试，告诉我味道
許伊贰叁肆 : 上海的葱油饼长这样(⁼̴̀.̫⁼̴́)✧好想吃
越越是杨咩咩家小老婆 : 啊想吃啊
清秀92391 : uoy
Zhang-JK-yu : 回复@一人的旅路:是的，在上海外滩，误打误撞去了一家酒店，我一看就是买不起东西的那种，哈哈，结果服务员还为我让道，
同事都叫我B哥 : 去过了，人家家里超有钱！儿子开豪车来接过[doge]
小郁青 : 再也没找到过小时候葱油饼的味道。不知道这家在哪里，好想吃[馋嘴][馋嘴][馋嘴]
莲心持 : @戌大傻 想吃
晚上木有吃午饭 : @蒋吹吹
Yikee_ : 爱玩客去过的
穆大人驾到 : 能不能说一下具体位置在哪里啊！[色]
HanAReum : 好饿[拜拜]
青菜青菜快走开 : @郭凯琦
芝士年糕鼠 : 莫名的感动，人生有多少个34年去坚持一件事[泪]
恨不能灭绝伪白兔的谢谢谢 : @请叫我蛋蛋涛O_o 学哥，去试试[眼泪] [眼泪] [眼泪]
萌萌的天麒 : 真的超级好吃，吃过
恨不能灭绝伪白兔的谢谢谢 : @请叫我蛋蛋涛O_o 学哥，去试试[眼泪] [眼泪] [眼泪]
萌萌的天麒 : 真的超级好吃，吃过
用户5674011548 : 这就是匠心～觉得很赞。
监控Abel : 看上油腻腻的，有啥好吃的，中国人就是爱凑热闹
一只二岁的少女 : 回复@Jackieone-W:藕色  感觉很香
jump孙 : 不能失传[good][good]
粒拾走由 : @-榴莲芒果君
Jackieone-W : @一只二岁的少女
笨蛋挞 : 好想吃
粒拾走由 : @-榴莲芒果君
Jackieone-W : @一只二岁的少女
笨蛋挞 : 好想吃
晓弘儿 : 好找吗？在哪
7_Vampire : 回复@7-28到底多远:嗯，你刚都说了，我☞智商高☜嘛~当然都知道啦[笑哈哈]
CEN是岑参的岑 : 看过bbc关于上海的美食的纪录片上面就有他，印象深刻
艾颇尔 : 7点下班去还有吗？ 。。。
tianweidara : 看着就觉得好吃！
彻__ : 术业有专攻
彻__ : 术业有专攻
辣条阻止了我做淑女 : 不知道收徒弟不
半夏夜薇凉 : 茂名南路南昌路路口 阿大葱油饼，下周去！
陈吃橙 : 厉害@宁_有猫
烧杯中的眼镜 : 看第一张图以为张艺谋下厨。
柠-檬檬檬檬檬 : 最后一张图说出了我的心声[哈哈][嘻嘻]
曾晨梦 : 没办法  看到上海我只想得到薛之谦[心]
轻轻轻轻轻轻轻轻轻轻轻轻的 : 具体位置？
赵小猪PIGPIG : @郭燕阁Laity 有机会一定尝尝
迷惘的小鹿miumiu : 想吃[馋嘴][馋嘴][馋嘴][馋嘴]
迷惘的小鹿miumiu : 想吃[馋嘴][馋嘴][馋嘴][馋嘴]
遇见风雪和旅人 : 情怀 [心]
北京老龙 : 看着就好吃
雪泥e : 肯定是天天做葱油饼 做的背都驼了
ChujinboSuperman : 回复@知竹竹知:bbc黑中国偏多，能不黑说明还不错。意思是一件事让你的对手服气了，也是你牛逼！
aN諾卡胶囊公司 : 金黄酥脆 香飘万里
曾晨梦 : @薛之谦 这家葱油饼你知道吗[色]好想吃
沐雪浅苏 : 吃过，确实是挺好吃的。但是我觉得四川巴中人民医院那地儿有个小摊做的锅魁比这好吃。
我见青山多妩媚hhh : 有时候看到别人的坚持，自己都会莫名其妙的感动
_nofor : 感觉不干净呀……
_nofor : 感觉不干净呀……
麓霏小妞888 : 不是上海的，是茂名的
明白zyl : 马住！找机会一定去吃！[色]
原谅我也有下雨天TT : 在上海哪里啊？
兔八哥的一天 : 求地址！！！！
Villa同學 : 平凡的东西做到极致真是了不起[赞]
暖暖暖暖暖犭 : @糖豆豆yan_再也不要叫糖豆豆了 想吃哎
farewell--fly : 他的葱油饼能扬名绝对是有原因的，看他的背都驼成啥样了，实在是令人佩服！
Amore莹儿 : 吃不惯南方的菜
Syinee : 想吃[馋嘴]
Syinee : 想吃[馋嘴]
Joyce改不了昵称 : 地址：茂名南路南昌路路口 阿大葱油饼
钓钓L : 好想吃，这样的老师傅真不好找了
白素华--SH : 有一个能坚持一辈子的事情，真好
MorningEnergy : 我是做葱油饼的[doge]
澍阳不带小尾巴 : @间歇性神经病的_7格
立志做欧洲人的小明同学 : 好想吃
重新出发的小仙女x : 想吃！
纵火青年Nick : 背陀成这样了。。真心祝福他
晶蛋哦黑的 : 老伯的背都驼了……有机会一定去尝尝
