凡凡stella : 行行出状元
我怎么会告诉你我是狮子座 : [doge][喵喵]@我会告诉你我是双子座 @我怎么会告诉你我是巨蟹座 @我怎么会告诉你我是摩羯座 @努力努力再努力x
觉醒AND顿悟AND涅槃重生 : 回复@你司波达也哥:你是处女座？
噼里啪啦轰隆隆_DD : @买几个萝卜切吧切吧剁了
d_bluebluesky : @文艺弹弓青年 想吃这个
Zoe和猫 : 看着就想吃
用户6013713738 : 辛苦了
决定勇敢的绿巨人 : 想吃
请你称呼我女王大人 : 小时候吃过类似的！好像先是在油锅里煎，再然后放火边烤。
老宅得男 : 回复@中国新闻网:我要去学徒
谢旪榭 : 回复@江有归帆碧水短:茂名南路159弄2号后门，刚才有人说了！  百度，百度！ 阿大葱油饼  上海话：阿度……阿大！
Ex_plo_rer探险家 : 最后一个不是王宝强？？
TV5XQ茶包 : 吃过，排了四个小时[失望] 
caicuix : 好想吃
畅叙茶园木易 : [赞]有些荣耀就是一辈子只干一件事
特别的人nanana : 我要去吃
大大大脸怪爱吃鱼 : 点赞[good]
uiiaouang : @TT酱酱万岁 我昨晚上刚看的BBC纪录片里面就有这个大叔！
_犭星_犭星_ : 这才是工匠精神，现在那些打着工匠精神旗号的来坑们拐骗的，都垃圾。
_犭星_犭星_ : 这才是工匠精神，现在那些打着工匠精神旗号的来坑们拐骗的，都垃圾。
一隻鱼er : 这种饼是真的好吃啊 现在都吃不到了 而且越是这种老手艺陷越多
张小鱼-Elaine : 坚持的力量[拳头][拳头][拳头]
三斤泡芙五花肉 : @蕾蕾小咕啾
RENQO : 这种感觉真好
Echo正在updating : 晚饭时间，这样真的好么！！
装作听得懂的样子 : 回复@爱吃生牛肉:了不起！
wuyuppp : @倪晨蕾- @Up-gina
11号口卖榴莲的小摊贩 : 吃过，就是排队排太久
ShEN__尐斐 : 给个地址，想去吃
ShEN__尐斐 : 给个地址，想去吃
御姐范的龙业 : 回复@杯中水linlin:我怎么没看见过 走遍中国应该有他
这未来那么重 : 第七张真是看的心疼了
夏艺璇呀 : 好想次
総武線 : 好想吃[泪]
正义的雷锋侠 : 说要去吃的，你可知道要排队三个小时？
一年13个月都在努力减肥的瑞星星 : 回复@张晫文:哈哈哈哈~~~好！！！我看能不能找到
我是一只鱼摆摆- : @蠢呆呆也很凶 吃这个
Leschoristes- : 看着就想吃
我是一只鱼摆摆- : @蠢呆呆也很凶 吃这个
Leschoristes- : 看着就想吃
Ayuko鱼鱼要健康 : 看着就觉得好吃啊   就这种才好吃
请叫我Simmons : @氡逆 想去看一看，，，
FZ雪--么 : 什么位置。吃起
风信子4095 : 可以去学这个手艺了
哎呀是宝宝啊 : 想买给你吃，可是我不在上海，你也不在[心]@TFBOYS-易烊千玺 【拿走不谢！ 阿大葱油饼的地址来啦[鼓掌]】三十多年的葱油饼， 一辈子的上海味。“阿大葱油饼”位于茂名南路南昌路路口。葱油饼5元一只，每人限购10只，而多数排队的吃货都会选择“顶格申购”买10只。想吃的，赶紧排队啊！[馋嘴]
冯大宝宝宝 : 好想次@路紫abc
Knightmare-Bao : @Sakura_大脸圆滚滚
糙面y : 想尝尝
不听不看不想不念 : 在我们那儿这叫锅盔。童年最常吃的早饭之一。
有方向的苝 : 值得尊重
hihachi1995 : 同时，他也很辛苦，背弯的很厉害
猫耳立立立 : 好想吃！
土豆阿鲁 : 有机会去多吃几个
萝卜汽水_ : 看着好好吃啊[泪][泪]
巧克力小芝- : @我不害怕落后那些幸福的人多少年 估计得老好吃老好吃了
蘑菇是小白兔 : @頔子頔仔
youzipupu茶茶 : 他收了好几个徒弟  都没能干下去 好手艺没人接呀
警惕交替 : 逼逼啥（BBC）
警惕交替 : 逼逼啥（BBC）
-刘hhhhhh : 回复@阿蒙是你叫的吗:你要告诉我地址
半半琳 : 看过介绍他的纪录片，佩服！！！
无与伦比真美丽 : 赞必须的
七月与安深 : 想吃
一个不会说话的瞎子 : 哇(⊙o⊙)[馋嘴][馋嘴]
洪欣欣婷 : 回复@外国人233333333:[泪][泪]上海……快递过来吧
_未及你_ : 我上周才在电视上看到…原来是BBC
微信hhjj4425你懂 : 看名字哦
Cynthia-Lili : @谁愿为我倾耳听
独自等待at__ : 回复@yan方方:茂名南路南昌路路口 [开心][开心]
江有归帆碧水短 : 回复@谢旪榭:在哪条路
Kotori丨Minami : 回复@吃土少女的日常QAQ:对对对 不给地址怎么一起去
夜静心澈 : 回复@谢旪榭:店址，谢谢~
xnfyll : 这应该拍一个纪录片的，像日本的《寿司之神》。
图图菜菜子 : @马卡龙太甜了 匠人精神
DL__yu : @sssssss599
朱小瑾儿 : @大梦梦大
Guoguo郭亚男 : @排骨和后秋可以炖豆角
扬氧icon : 我下次也要吃
扬氧icon : 我下次也要吃
挖一口深井_ : [喵喵][喵喵]在地铁上饿着肚子看到了这条微博。。我感觉我的胃在呻吟.....
野生三毛 : 这个对不吃葱的我来说 是遗憾
饼饼minmin : 好想吃
李大王大王 : @非得腻死的光圈 我居然没吃过！
iQINGLANMSLOLA : @施翔文Sanwin 看起来好好吃！
醬鴨滷肉叉燒包 : 去哪吃呀
--小香-- : 坚持了三十多年一定超级美味
丫丫YY929 : 之前群里有同学去买过
RRRRROUTTTTT : 国庆又要堵成狗了[哼]
喂哈嘎啊咖 : 看来我吃的都不够正宗[doge]
秃尾巴的猫儿 : 看见这个也想吃[哆啦A梦吃惊]@丶萌萌哒的Doctor
狻猊最好吃 : 看着都有食欲
Daniel_东方 : 牛
HAAALO : @野渡无人舟自横LL
吴小小小蕾lei : @Miss_陆姑娘 看着好饿！
小黄瓜上的小黄花 : @啄木楠 就是我们去买蛋糕那条路[doge]
_OFFICE : bnc中国新年看到过[心]
亚里士缺德0 : 好想去吃，留个地址：茂名南路159弄2号后门(近南昌路)
大镇姑娘 : 想吃
一瓶二锅头喝的眼泪流 : 一定很好吃，饿的我不要不要的了！最好不是甜的！
金子虹 : 太不容易了！有机会一定去光顾一下～
米小姐的多肉园子 : 回复@爱哭的我却是孤独的她:对对对
小透明家的包子 : 这种传统食物对我来说  卖相不管好不好  看着图片我唾液就开始自动分泌了[笑cry]
Adam-Kun : 太有毅力了，我们这种年轻人都没有的毅力，好佩服！
姓氏郭- : @小茜原来是这样的柴柴
yan方方 : 回复@独自等待at__:我知道，我是说有没有具体地址呢？
任金刚同学 : 回复@顿顿想要好好生活:together！
11楼d小怪兽 : @哈喽小昕儿
昨天没约好今天 : 其实像这种纯手工的小吃摊逐渐被商铺代替，也越来越贵，至于未来做的好不好吃，我不评价，重要的是希望能继承下来
若水安然_ : 老伯伯的背都驼成这样了。。。可以把手艺交给子孙传承下去呀
z_axi : 我一定要去尝尝[馋嘴]
HXR-TWH : 求地址
DwyaneWei喜欢听伴奏 : @刘小逗逗逗逗_ 那该有多好吃呀
苦行小猫 : 谁能说下店的位置
Rrrrrrth : 确实 一个生活在江南古镇的人告诉你巷子里的东西往往是真美味 简单的包装 行云流水的手艺 是传统美食的象征(...怎么觉着有点舌尖上的中国的味道)
呆呆星球郡主 : @Frank常扬 想吃
夏天的绿叶子 : [色][色][色][色][色][色][色]
呆呆星球郡主 : @Frank常扬 想吃
夏天的绿叶子 : [色][色][色][色][色][色][色]
Eurekkka : @周真美zm 看起来真的很好吃的样子
HXR-TWH : 回上海我一定要去吃
皮皮瘦肉小粥 : 想吃
乾乾惕惕咫尺天宮 : 也是没有办法。。。
逸缕涂鸦 : @活着有酒酒里有梦梦里有你
--王不二-- : 回复@健忘症的邻居:[doge]我操，你真是到处拔草
--王不二-- : 回复@健忘症的邻居:[doge]我操，你真是到处拔草
要一本正经的胡诌八扯 : 回复@Ja德满奥利奥:嗷...现在好饿[笑cry]要吃！
VICTOR涵_ : 老伯的腰都弯成什么样了 希望文化能被传承
赫鲁晓默默 : 我喜欢吃葱油饼[嘻嘻]
a甜儿吖 : @刘六两- 你去尝尝我馋死了
有柴你就来 : 收我为徒吧[作揖]
凉爱LOVE : [good][good]
梦想家美人 : 我想吃，超爱吃[馋嘴][馋嘴][馋嘴][馋嘴][色][色][色][色][色][色][色][色]
毛毛的世界TM : BBC是什么
时光总是无语 : 吃一次排个队两小时
memrot : 地址是哪里？
张太阳立于心__v : 回复@一人的旅路:你能不能不要以偏概全
健忘症的邻居 : 回复@--王不二--:比别家厚，大，不需要神化，而且除非闲的，一般排不到
Care50947 : 辛苦了
梵高梵高 : 好想吃哦
哥哥-aihily : 回复@涅瑟唔了:味道怎么样，具体地标在哪里啊
哈哈萌子 : 以前在大连的时候吃过一种蜂蜜面包，趁热吃特别好吃，每天都有人排队
独自等待at__ : 回复@yan方方:上海呀
草根老丁 : 回复@知竹竹知:想多了吧，人家BBC有个纪录片而已[汗]
葱爆菠萝 : 这不是锅盔？
Luuvy_ : 回复@mlxsjie:肯定好吃的
The圆子 : 就是这种巷子的东西，外貌不起眼的东西才是最好吃最有故事最有情怀的。真的好想吃，我也最喜欢吃葱油饼。那些怕死的就别吃了，你们太娇贵，去高级餐厅合适，起码人家用垃圾做的东西也会觉得高尚
史兜兜DE妈咪 : 在哪啊[花痴]
任阿_Ren : 大爷在哪里[思考]
离人挥霍着眼泪0606 : 图三看着想吃
adaizy : 看过一个纪录片…就…似…他！！！[鼓掌][鼓掌][鼓掌]
栗子李子和梨子 : 图片评论 
花园绘里香 : [good]
埃姆斯诶一98986 : 最后一张图，王宝强也干这个了？
股海摆渡文 : 回复@中国新闻网:茂名市？
漂酿脸蛋子 : 是不是里面有肉馅儿啊
内蒙东胡 : 地点在哪里啊？
Halfdegree_ : @水果姑娘Ariel
追不上的鸠 : 我看了这集 说他是小说里的黑武士 的确令人印象至深的老伯
青青青青青小雨 : 看起来就想吃
淺涙的時間 : 多辛苦背已经驼成那个样子
淺涙的時間 : 多辛苦背已经驼成那个样子
s那一片珊瑚海 : 人们对于美食的追求永无止境
哲beryl : 回复@想念如果会有聲喑:就知道吃[哼]
山本姑凉 : 我吃过，阿大葱油饼，排了一下午的队[爱你]
Lee穷胸极饿 : 看过那个纪录片 但感觉很不健康
哈尼的小确幸 : @九爷0729 就是这个
饺子手 : 想吃
单细胞生物-Z : 回复@涅瑟唔了:请问在哪里呀？
秀茵妹妹 : 圖片評論 
miko设计师 : 看过bbc的视频，大爷棒棒的
