病妆皇后17K : 回复@s好多多的云y:貌似是高速公路上
夏娃和果子 : 好无聊的人
T-VanSing : 回复@纷纷z:哈哈哈哈哈[doge]同感
用户5842414096 : 特别恶心开哈弗的，同意的点赞，
雨后青山ZX : 也是无语，拿自己生命开玩笑。
也许是吧1205 : 太不要脸了
阳光1978912 : 真虎。这样不犯法吗？
s好多多的云y : 说到底还是怂   咋不下车干一架，开着车不疼不痒的还祸害别人
迷路甜甜喵 : 都以为自己开的是坦克吧。。啊哒哒哒那样
無意間看見袮 : 我追啊追啊不害怕我就撞你。你来啊来啊不让道我就别你。
齐尔哈朗 : 有钱淫，
郭聪44464 : 济青高速啥时间段这么清闲啊？
兴禾富有 : 活够了
Liu7__ : 速度与激情
林夕52099 : 吃饱了撑的
多多的胖哥 : 车子越是烂，开车的就越是屌，屌丝得一B，炫耀自己有车了，吗的智障
希望一切都是蓝色的 : 回复@ctinyj:总觉着还是原装的好，花钱买的，总觉着舍不得[脸红]
海边小言 : 回复@遗梦_江南:也就头像可以评价一下，否则你让我说什么？
急急如令令小涛爹 : 哪一条高速  G20？@人民日报
佩文森特 : @静静想一个人静静-
来二斤牛肉先 : 大货车低档踩油门，都不用按喇叭[doge]
小船儿荡起波澜 : 死了算了，省的下次无辜的人开车遇到就糟糕了
一块腹肌的妞儿 : 视频过程不完整，下这么早的定论谁对谁错，尚早吧…
东致-初原创 : 白车太坏了吧？为什么要这样啊？
龙卷风一样的男纸 : 轮胎爆了
孩子我不能失去你 : 求求你们救救我
心事重重的沙发 : 玩的没我好，放钉刺带啊
向佑昔 : 碰碰车
月下青衿染蒹葭_ : 警方介入调查，嗯，应该是调查背景去了，看看能不能管，能管就罚两千，不能管就当没发生，很好啧啧
ZZzzz了个秋 : 回复@陈炜剑_:于是 横尸遍野么[眼泪]
心情迷宫tua : 一人我饮酒醉，醉把前车怼一怼，二人我不服谁，就速飙车谁怕谁，你撞我保险杠，我挤你车子没商量。二营长，把老子的杨永信拉上来，这两人须要治疗！
跖窳觋 : 必须直接一律按危险驾驶罪定刑，任何部门都不能以调解方式处理
卖女孩的yura : @Sen-m1tsuji
遗梦_江南 : 回复@海边小言:卧槽 你在网上调戏良家妇女啊
德耳塔delta小于0 : 每人罚上个百八十万，在判上几年，终身禁驾。毛病都是惯的
陈炜剑_ : 允许持枪 就不会有种烂事发生了
执笔LLL : 回复@徐瑞道9625:看吧……妥妥的弱智
iAm阿申 : 秀的飞起[微笑]
潘太帅同学 : 回复@江左一城:看了速度与激情还是看了极品飞车？[微笑]
江左一城 : 黑车技术太烂：教你们一个方法怎么弄翻白车，白车从中间车道向超车道别黑车时，黑车猛加速方向猛向右打将黑车右前轮撞向白车左后轮前方一个轮胎位置那里，就可以把白车顶到路边绿化带去了，然后黑车松油刹车握紧方向盘约一秒后回方向盘。完。
leon-1010 : 有病，吃饱了撑的，想死换个没人地方
应悦尘困死猫 : 估计都不想活了
可是我还没 : 生死看淡，不服就干。
XXX081 : 可以可以 这很山东[笑cry][笑cry][笑cry]身为山东人……感觉一身正气哈哈哈哈哈哈哈
老朋友_91710 : 作死
曦幺幺_ : 这种人一辈子不准开车
香城雪子 : @i然儿 @晖Magician
o潘多拉拉89776 : 高速上，找死
你永远都看不到我心中的泪 : 不会开车，不过光看这段，白车不是故意的么？你让人家先过去怎么了。蛇形影响后面车辆行驶。太作了！
Baby来一发吗 : 回复@tomotomohisa:我不会这样[哈哈]
徐瑞道9625 : 回复@执笔LLL:傻狗 使劲叫吧
青蛇腾舞 : 严惩
海边小言 : 回复@6673yyy:你的头像比较漂亮。
小茂哥儿 : 你玩过GTA V吗
LauLawliet : 直接拘役
河道插眼被淹死 : 这么宽的车道也能发生争执 我是服的
作家韩晓倩 : 珍爱生命，远离飙车
马答应 : 男司机？？[微笑]
等待清清 : 回复@薛小扁:[good][赞]
骑着驴撵宝马 : 都是钱烧的！有本事找个空地对撞去，看谁先死。
我是杨洋咩咩咩 : 应该是黑车司机被气到了，多次想超车都被堵，感觉白色的车故意的，真缺德？
小PQ的幸福生活 : 🐂🐃
tfddb : 这互相不服输的劲头，用在哪不好，非得用在作死的上面！
陌外小仙儿 : NO ZUO NO DIE
Boilingblog : 自己不要命，别害别人啊！
怡路-有你 : 违法乱纪的请严惩！
u_uRainbow : 最讨厌那种乱加塞的  别人都排队 就你有本事 就你厉害能加塞是吧  就不让你
猫小狸爱吐槽 : 你俩想互相碰就面对面的怼，看谁车速快，看谁死的快。
执笔LLL : 回复@徐瑞道9625:我不是针对你 但我就是觉得你这个说法像个弱智
是舍长不是色长 : 就不能把车停旁边，下来打一架吗？
喜欢喜欢超喜欢x : 这@君还记-一袭水袖丹衣
薛小扁 : 回复@等待清清:这种斗气司机应该同归于尽才好，是对人类劣等基因的有效淘汰。
双手插兜说声嗨 : 这种开车的最好俩人打个头破血流，能死几个死几个，别给大家添堵。
木卯博元 : 作死可以，别殃及无辜就好，阿弥陀佛！
绷绷绷不住了 : 白色越野如果是霸道那我就理解了
临沂李官 : 终生禁驾
朱德康 : @爱王杉丶
nswdbzsc : 真是够了[生病]
嗯哈哦哈 : 起亚亲哈弗，哈弗不给亲，一路首.我陪你缠缠绵绵到天涯[吃惊]
哈气小姐 : 疯啦咋滴
新余婚嫁网 : 这两车不用多说，估计平时就都很拽，马路是自己家的一样，都不把别人放在眼里的那种。正好碰到一块就掐起来，最好两个一起撞死掉，免得祸害人间。
面朝大海的农家乐 : 长城H6啊，最吊的一群，人车绝配。
种花家的完颜酱 : 山东高速路好走，也不带这样啊
蔚蓝的天清澈的水2016 : 会不会，警方已危害公共安全罪进行逮捕？？？？？？？？？？
开心时刻渐少 : 以危险方法危害公共安全罪
我_心_里 : @我_姓_李 厉害了
24K纯二青年 : 两破车挤个什么劲？
le-floater : @文刀议
程-尼-玛- : @聪葱骢冲
故吐纳新 : 路怒症，病得不轻，得治！
基层平民世界11 : 什么素质？
WANg微微11 : 祸害人
杨深梦断2015 : 两司机必须刑事拘留，吊销驾照
厦门利易工贸有限公司 : 不能这样
夜空中最亮的星XKY : 就想问问还有谁[doge]
CHARRY的幸福生活 : 死刑！要不然害死别人！
是蜜喵啊 : 回复@等枫红染秋季等相遇z:反讽有什么绝对不绝对的，毕竟他们说女司机时话可比这个难听多了
玩命滴雨子 : 耐心哪去了？
辛辛-Foreverever : @Come_as_KEN_is
远方止一弋 : 凡事斤斤计较，何苦呢[汗]
多汁杏鲍菇 : 拍片现场，不明群众乱入[笑cry]
地球的另一端LY : 判刑
如鱼上岸jeremy : 直接吊销驾驶证，终生不得考取！
Jeyton : 这种就应该下半身残废度过
郑州市城市管理局 : [doge][喵喵]两位，当你们两家的老老小小看到你们酱紫开车，一定不会觉得你们是在为这个家争脸！[拜拜]
还剩四片土豆 : 后面要是辆挂车，俩都没了，渣渣
云起清朗 : 高速上这样。。卧槽。。后面来一辆高速大货车就boomboomboom～啥都没了～这不只是玩自己的命也玩别人的命啊！永久吊销驾照！
Dang宁_ : 路怒也是有原因的，例如我们这某些出租车随意抢道加塞。还有某些车不停按喇叭。。
等枫红染秋季等相遇z : 回复@是蜜喵啊:看的懂 只是你的话有点太绝对了
平雅W : 遇上俩暴脾气，这样的人早晚出事
菜菜-蔡晓兰 : 回复@酸菜就酸菜:。
浅浅谈谈有 : 这时候为什么没有大货车、让他送你们一程
叮咚响的相机 : 想起了头文字D里死亡胶布战那集： 秋明的AE86只有进拆卸场的命！ 撞击失败…… 我的EG6[泪][泪][泪]
酒足饭饱撩2嫂 : 回复@春和景明和你:不要命了
活在当下NF : 这个应该以“危害公共安全罪”定罪
我就是不生气啊 : 狗咬狗一嘴毛
布达拉-寒流 : 俩车主都应该判刑！危害公共安全罪
迷糊錢多多 : 我只关心死了没？[怒]
张泽鹍_ : 是不是聊城的？
Fats_Shady : 搞事情？就知道搞事情，命都不要了，还威胁到别人的生命安全
物理教师001 : 最好找个没人的地方，你们自己喜欢怎么挂，我真的无所谓，只是，别影响别人。
黄飞老师 : 我们山东人上个新闻，要么是青岛大虾，要么是临沂电信诈骗，要么是烟台冰雹，这下好了又多了一个。心塞
桐谷珺瑶 : 尼玛的想死去秋名山啊！
zyquscle : 必需以危险驾驶起诉
为什么不呢why : 狗咬狗真好玩[doge]
beyond行者 : 一般平民不敢这样撒野吧
beyond行者 : 有关系？
可爱的木头人 : 亲眼目睹了两辆事故车，两辆车距离较远，当时还在猜测发生了什么事故[吃惊]
Hood-Yao : 以为自己是潜在的灵魂车手……需要被激发…
髙巐 : 智障？
修车老头 : 回复@手机用户WANGKAI9781:两车道 济青无误[微笑]
杰客无为 : 评论更精彩。
o辉色轨迹o : 这样的都应该送前线去打仗。
福星高照DY : 拿命开玩笑呢吗？[疑问][怒]
手边流淌的河 : [吃惊][吃惊][吃惊][吃惊]
阑珊处是你 : 其实他们是在拍戏呢
Hantor : 黑车司机技术太差！
hide侠 : @___Lyyydiaa
木昜飞扬 : 澎湃新闻，今后无论真假一概不信！
马大爷的姿态 : 这俩司机是山东倔县的人
-Ayalkomod : @郑郑症
ctinyj : 回复@希望一切都是蓝色的:主要是人太好了啦。不然撞上去，你刚好可以去翻新下加做个保养什么的[挖鼻]
希望一切都是蓝色的 : 回复@海边拾贝壳的Boy:贵的也买不起啊，只能忍着[泪]
希望一切都是蓝色的 : 回复@ctinyj:关键是心疼自己的车啊，要不真想直接撞上去！
希望一切都是蓝色的 : 回复@袁硕七年:对啊，上次我妈开车就有个直接冲进来，把我家车镜子都擦了，正好在收费站，我们说他，他还说他就要跑这条道儿，横的要命
马君_诺亚 : 不作死就不会死，以危险驾驶罪论处
军林天下winner : 直接去跳河快点
轻舞飞扬75307 : 碰到过这种车，你一想超车前车就要变道。
hua芳馨 : 香港警匪片看多了吧
虎的牙牙 : 严重危害公共安全
击败独孤 : 找死别害别人
酸菜就酸菜 : @菜菜-蔡晓兰
6673yyy : 回复@海边小言:不愿意。他全责就撞我。啥逻辑。。。杀人犯还全责呢。杀个你，杀个你家人。杀你家狗你都不乐意。。。
手机用户2001936167 : 学谁不好，学三星
守望夜空中最亮的星 : 这不就是杀人？害自己更害别人
白开水administrator : 碰碰车
白龙马的生活 : @小老虎和小松鼠
陈宇江 : 保险不赔
橙恋2010 : 作死
理游 : 虚伪的‘人性’让没人性的渣滓越发的猖狂，邪恶的流氓法制让违法犯罪成了一种‘生活方式’！虚伪的‘人性’把人的生命尊严变得毫无价值。变态的法制规范造出这些一边藐视残害生命一边将自己伪装的道貌岸然的‘变态’渣滓。在流氓法制社会，能实现的只有噩梦！畜牲不如的渣滓搞的‘法治’比邪教更邪恶！
爆笑的青蛙 : 终生禁驾最合适
徒步旅行的海龟 : 俩人死了吗，死了在报道吧，不管谁对错，这样就是在找死
高焕垚 : 回复@芍药_花:人争一口气，脾气太暴躁了
简丹幸福90 : 回复@imckx:就你好
张大叔很潮丶 : 找死的节奏，
猜猜猜谁能猜出来 : 从视频内容来看，白色车主命不会太长！！！
V光哥哥 : 回复@飞yao:牛逼！这些人不要命了❗
齊蟿 : 行车记录仪车主，你也是不要命的主[好棒]
用户5714464108 : 涉嫌危险驾驶，危害社会公共安全，扣12分
勇2018 : 回复@李光新_leo:百度旅游特邀行程规划咨询师
阿亮微电影 : 现实版头文字D，给101分不怕骄傲
别让时间非礼了梦想1919 : 且行且珍惜啊，[祈祷][祈祷][祈祷]
脑残的劫后余生 : 摇号快六年了。前三年摇不上号，只能骑车上班，结果被车撞。现在又三年过去了，只能走路上班。我恨摇号，我诅咒组织摇号的人，诅咒组织摇号的人都头上少块骨头。
佑得 : 碰碰车确实不是娱乐项目
imckx : 真心讨厌山东人
aeflor : 《速度与激情8》开拍啦？？？？[吃惊]
许伟尧_340 : 呦～极品飞车啊[笑cry]
应星刘_218 : 还是素质和教育不够普及，大家都要礼让三分。都是同胞啊，有本事去跟日本和美国搞。
山东反邪教 : 不是斗气，是玩命！
飞yao : @V光哥哥 看看高速碰碰车
辍拐 : 危害公共安全当场击毙才是
爱国偏多屠狗辈 : 黑车是起亚，大家别买，掉保险杠[喵喵]
范范美甲半永久化妆 : 家长责任大
FTHz- : 请不要有性别歧视 一天之中交通事故千千万 怎么不见你们报道的时候加上男司机之类的词语
TST活酵母东北大区总代__娇宝 : 干嘛强调女司机！！！              如果是[抓狂] 男司机[抓狂] 就该玩手机吗！！！              还是如果是[抓狂] 男司机[抓狂] 玩手机就不会撞死人！！！           还是如果是[抓狂] 男司机[抓狂] 撞死人就不会被谴责！！！            还是如果是[抓狂] 男司机[抓狂] 撞死人被谴责就不会被法律制裁呢？？？？？？
贝刻官微 : 标题太烂了，现在的人，没有一个标签都不敢说是中国人
沐若绝 : 回复@Eva_Ye的后花园:前段时间有个新闻    大一新生百分之八十不会装被子
璟禾呈 : @西风14级 开车不要玩手机
沐若绝 : 回复@猫林居士2012:不管坐的矮不矮吧     一个大人不好好看着自己小孩就算了，车来车往的，三个小孩的大人就那样让他们坐哪里也不管    都不珍惜生命    能怪谁
白水井恶霸 : 回复@哆啦A梦只有梦i:我看了新闻，孩子没有生命危险，就是全身多处骨折。看的时候新闻说还有一个孩子在昏迷中，不知道现在醒了没有。
SueLBT : [吃惊][吃惊]
獬豸与猫丶温柔一丨刀 : 那个说“男”司机就会没意见的，性别歧视针对的是男的？
沐若绝 : 回复@郭静漪pink:一个大人不看   三个大人也不好好看   到处都有熊孩子
豌豆上公主 : “疑”看手机，实坐路中。
末日听晨 : 回复@TIng哟哟:好好好[害羞]
獬豸与猫丶温柔一丨刀 : “疑”看手机
沐若绝 : 三个小孩的父母为什么不好好看着小孩   让他们坐在停车位上
一起HAPI : 不一定是看手机的，这个车右拐，且右前方有障碍物遮挡视线，其次司机都应该知道，右前方有视野盲区，再次，孩子是坐在地上玩的，车前脸高的话是有可能看不见小孩的，开SUV的都应该了解，小区内最怕孩子突然窜出来，因为根本看不见！！！所以，既应该提醒广大司机，也应该告诫各位家长看好孩子！
羊羊羊羊洋半仙 : 司机有问题，孩子也有问题!怎么算？[思考]
修真的猫咪 : 我想知道孩子怎么样了 说那些有用么
Thelosttemple_ : 每当报道男司机出事时，一些女同志会说“啧啧，是男司机啊[喵喵]男司机出事多嘛”之类的话，而报道女司机出事时，她们会说“为什么要强调是女司机[怒]你们这是歧视女性！”长点儿脑子吧，像这种女性完全是活的很自卑自己在歧视自己。
神经衰弱睡不醒刘刘牛晓欢哩个欢 : 有些时候会有死角确实看不见
邱秋and秋 : [疑问][疑问][疑问]关注点怎么全在性别上，不是应该在开车玩手机酿成悲剧上么？怎么这么玻璃心
闪亮亮的锵锵锵 : @robertocc [吃惊]不要开车看手机啦
_aaaaaayoki_ : 目击者你是怎么知道司机在看手机？还是一直？
吃老虎的兔子-- : 回复@懒惰三分钟热度可不可以好好加油:举报，死刑
小瑜不吃鱼-- : 为什么一定要强调女司机呢？男司机就没犯过错吗？我也是女司机，从科一到科四全满分通过。上路后从未发生刮擦，从未因速度慢被按喇叭被赶超，停车倒库全一次进入，相反很多男司机停车，看得我着急。请不要性别歧视，别动不动就女司机女司机的强调！女司机有反应不灵敏的时候但不代表男司机就全是车神！
hermione0606 : 这个司机估计要坐牢了
yukiindiewelt : 回复@呆呆小朋宇:另外两个女生打架这种新闻标题还少了么[微笑]
yukiindiewelt : 回复@呆呆小朋宇:所以你的意思就是男司机撞人了不能用男司机？
依静丫 : 这种垃圾就该死，祈祷孩子没事[祈祷][祈祷][祈祷]
呆呆小朋宇 : 回复@yukiindiewelt:那举个例子，比如说两个人打架，一个女生被打了，你希望新闻上说有人打女人这种人太不要脸，还是想看两人打架有一方受伤呢？
懒惰三分钟热度可不可以好好加油 : 回复@吃老虎的兔子--:我还真的见过有个司机左眼受伤完全蒙着纱布居然还在开车的，我当时都惊呆了[喵喵]
懒惰三分钟热度可不可以好好加油 : 真的很恶心非要强调女司机，大车祸男司机多了去了，而且发生事故的比例男司机明显多得多，智障一样的[微笑]现在高速上开车都要玩手机何况是停车场？那些一只手举着手机放在方向盘上一边玩一边开车的司机都请原地爆炸吧[微笑]
林傍晚 : 不过有的家长教育孩子也是简直了[微笑][微笑]
权志龙与大爆炸 : 孩子当马路蹲着玩，作死！ 司机在开车玩手机，玩命！ 横批:MDZZ
没头脑和不高兴gfk : 开车看手机 害人害已
吃老虎的兔子-- : 不管谁，开车能玩手机吗，自己不要命，别人要。你干脆蒙眼睛开车好了。
思空幕语 : 为了你我的人身安全着想，开车的时候不要玩手机，理应专心开好车。再者，出了事故，也不能选择逃避来推卸责任，而是要勇敢地去承担。@光之源2016 
水鸟湖泊 : 开车玩手机，真的对自己和别人的生命都很不尊重！
水鸟湖泊 : 开车玩手机，真的对自己和别人的生命都很不尊重！
RoseJierrr : 回复@RoseJierrr:作为一个公交车司机，应该把精力集中在开车驾驶上，边玩手机边开车首先是对生命的不负责任，其次显示了你的职业道德真的是毛毛雨
雪贱三尺 : 家长司机都有责任，家长怎么教育的
RoseJierrr : 之前《新闻大求真》里做过一个车辆儿童盲区，之所以还会有这样的事发生是因为没有人真正去在乎，去关注！况且那么小的孩子家长为什么不做好安全工作？真是心够大的
-卍_ : 上次过马路有个司机两只手看手机  ....方向盘闲置...
小含jjj : 还有开车斗地主打麻将的呢！真不知道他们把生命当做什么？
刘桤威 : 不应该是轧过么？怎么是压过[喵喵]
郭静漪pink : 讲真 大人平时没有教过孩子吗？停车场是可以坐的？
阿丹西铁路 : 天呢
蝴蝶粉-纯中药丰胸暖宫调经 : 家长要看好自己的孩子啊[哼][哼]
哆啦A梦只有梦i : 我只想知道小孩现在怎么样了
恋有几分小雅 : 都有不对 但是说活该的人 是不是很过分呢
梨黎爱 : 有些人说是因为女的个子矮。。科目三考试一开始让绕车一周知道是为什么嘛？为了检查有没有小孩或其他生命和障碍！
-小Ant : 车主没问题，这是盲区好吗？谁看得到...车主也是倒了霉了
vipasyin : 回复@爱我爱我baby:至少常识性的东西知道。至少自己带孩子的时候不会放任孩子跑到道路上去玩！
小鼻子的微博咯 : [吃惊][吃惊][吃惊]
龙--囍 : @Darkie-梓 不忍看
Hz的张小鬼 : @澎湃先生 @澎湃先生 @澎湃先生 [衰][衰][衰][衰][衰][衰][衰]
TST活酵母东北大区总代__娇宝 : 干嘛强调女司机！！！！ 男司机就该玩手机么！！！！
TST活酵母东北大区总代__娇宝 : 家长即使叮嘱了孩子，你司机就该玩手机么！！！！
SuperFyuan : 女司机怎么了？！再说了！为啥不看好孩子？！监护人呢？孩子不懂事大人也不懂？！平时不会教育么？
超级老浣熊 : 不管谁对谁错，这种已经构成了交通肇事罪，首先要追究刑事责任，再追加民事责任。
TIng哟哟 : @末日听晨 开车不能玩手机
ZapJuly : 中国家长一向都是只知道一味的纵容，不知道合理的约束，才会造成孩子无法无天想怎么玩就怎么玩，想去哪里玩，就去哪里玩。不过司机也有不可逃避的失误…
叮当喵6020257877 : 都他妈作死[微笑]那死做一堆好不好[微笑]开车别玩手机    走路也别玩   。 孩子要看好 ，现在车那么多 。家长是在吃屎吗？
兜兜不想转转 : 开车远离手机，跟酒驾一样，家长也得看管好孩子！还好三个孩子活着[祈祷][祈祷]
王艺wongwi : 性别歧视 滚好吗[微笑]
喜歡白羊座的你 : 开车看手机不要太多 还见过一边开车一边看剧的……希望可以像酒驾一样严惩！
Eva_Ye的后花园 : 自古以来说无规矩不成方圆，而现在我们有多少事是真正按规矩办事的？
Eva_Ye的后花园 : 我特别不理解 在中国 只要出事都是机动车的问题 说保护弱势群体 最后开车的呈弱势群体了 这个角度 孩子坐在那 有视野盲区 如果司机从后面上车 根本不会知道有孩子在那玩 在中国 人行道就是规定走人的 很多人不走人行道出了问题 那就应该不走的全责
Ma-RRR : 果然，时代发展这么多年，女性地位依旧低下[斜眼]
微微风来灬 : 这个司机太倒霉了，孩子太可怜了。以后我都不敢随便开车了，想想都后怕。
歪歪923 : 回复@nianyixinan20132:我说了啊，这个司机确实不对，但是家长也要管好孩子。好好看看再评论呗[喵喵]
aaaaaaaa5776 : 回复@可乐奶昔不加冰:女司机，女司机，女司机。
Eva_Ye的后花园 : 家长为什么让小孩在停车场玩 我就奇了怪了 不要说家长不会24小时跟 这是孩子应该知道的常识 在什么地方做什么事情 就事论事 中国的孩子被保护的太好 最基本的生存常识有些高中了都不知道
豹纹面包 : 哎
黄慧兰hl : 有些司机就是喜欢这样，不想多说
刘梦蓉mengmeng : 不看手机 前面蹲着三个我也看不见
桃子的青春舞曲 : 这家长是故意的吧，送孩子去黄泉路也太明显了吧
廖谦爱自己 : 不是我说，开车真的是，有些地方真的看不见好吗？不要一说女司机就逼逼，自己不看好孩子怪谁？[拜拜]
陆陆别闹我有药 : @哦吧走开我有病 看到没，开车不要玩手机
aroundight007 : 司机开车玩手机是不对，但也请家长看好孩子
雪雪二宝贝 : 怎么教育孩子的，别光说司机，有在停车场坐地上的吗，有在大马路上坐着的吗，孩子没学好，就是大人教的不对。
小企鹅恐惧症 : 是手被压断了么
乐Cutegirl123 : 作为一个家长表示，在外面家长真得一直跟着看好！孩子可不知道什么是危险！这还是三个孩子！司机责任肯定也逃脱不了
yukiindiewelt : 回复@无敌兜儿宝:你见过有车祸新闻标题带“男司机”三个字么？女司机特殊？
yukiindiewelt : 回复@番号259huxu:随缘？大街上那些开面包车，出租车的都挺随缘的，想怎么变到就怎变，灯也不会打的，突然拐弯吓死你的不在少数，99%是男司机，沉稳？我开车这么久，撞我车子都是男司机，最后交警认定他们全责，基本就是把油门当刹车[微笑]如果这些事情上新闻，请问标题会标注“男司机”么
yukiindiewelt : 回复@呆呆小朋宇:因为我们从来没有看到“男司机”这样的标题[微笑]
苏易贞 : 为什么男司机肇事就直接写司机，女性司机就非加个女字，强调性别有必要吗，我看到的开车爱看手机的男司机也不在少数。
sophiaou : 中国的很多家长根本没有做父母的资格
昊妈Jessica : 我的天，小孩怎么在哪里坐着，家长心里怎么想的？
好姑娘永垂不朽o_o : 把女去掉，谢谢
吃饱不露皮肚 : 要是我是司机我他妈冤死 真是倒八辈子霉碰见小孩这么玩
数学考不到90不改ID : 回复@远方的信笺999:可能是你想多了吧 只是想说这个司机是女的而已。。。[吃惊]
李文洁95 : @Jack-wym
我是智障龙的脑残粉_bb : 卧槽 小孩子没事吧
ChristinaWang圆圈 : 请问这三个孩子应该坐在这儿玩么？要按路权来说，难道车不能在马路上开？
大学问津 : 开车要专心
俊凯我的exclusiveO2 : 我之前也看过，一司机开车时玩手机，还是公交车司机…！！我看得清清楚楚。因为我在隔壁车，不仅在玩手机，玩的还是微信，，抢红包…………
凉到你喊娘 : 女人开车就是可怕  说实话
Sablababy : [doge]我只有一个问题，文中说到现在只有肇事司机家属出面，肇事司机没出面，文中结尾写，肇事司机和车被警方带走，那肇事司机怎么出面？
大大傻一个 : 开车还尼玛看手机[弱]
呆呆小朋宇 : 为什么不能说女司机，如果这是真的的话，说了没有问题啊，因为说了女这个字就有错的话，那以后说话都别带性别了
贾寳玉 : 悲惨，心痛。这么碾压，不死也残费了。给3个家庭造成多大的伤痛！太可怕了！[悲伤]
So_Suri : 雙方都有責任。
南墙临君 : 回复@茉莉没茉莉:而且昨天这件事的微博是没有女司机三个字的，我当时看评论，有人说终于不用女司机搏眼球了啊[doge]真是立了个flag
南墙临君 : 第一，昨天这条消息没有用女司机搏眼球[doge]我不是针对谁，我是说用女司机的所有博主[母鸡]第二，疑玩手机，这说明有可能没有玩，仅仅表示猜测。而且小孩本来矮又席地而坐，这辆车车头很长，司机可能看不见。上车时如果从后面上车，是有一定几率看不见的。第三，什么家长？孩子坐在车前面玩心有点大啊？
我是小囡的主人 : 注意安全@小伙明天会更灏 @我是小豆浆的主人
最无情最冷酷最无理取闹o : @苏阳洋yangyang @苏阳洋yangyang @会飞的毛斯 吓死我了
大雾散开 : 针对事，别扯远
An金渔 : 一般司机在停车场又没什么人大多数都放松状态下，停车场小孩在玩家长没管好这责任极大，当然司机也有责任
茉莉没茉莉 : 首先不管车主男女 尚且先说路人目击说肇事司机玩手机 ！ 可能你视力真的有这么好 ！！！角度来看 车头高于孩子 倘若说属于视野盲区 也说的过去 其三 这么小的孩子  监护人是智障吗 把孩子放停车场大马路中间玩  ？你心是有多大 ！
爱我爱我baby : 回复@就是偏爱猫:空间那么大  眼睛瞎吗  看不到
爱我爱我baby : 回复@vipasyin:你和你的家人小孩  再生活中就 刘活的那么规矩？  没有一点点不对？
李开心er爱瞎闹 : 我拿驾照五年了就没掏出来过，让他默默的在兜里吧，不想去伤害别人。好多人说自己开车没问题，是因为他压根不知道什么是对的，他就不觉得自己有问题了
武林----萌主 : 某些家长，让孩子公共场合乱跑，打架，撞人，大叫，还笑嘻嘻的看着。看看地铁，博物馆，书店，，，就跟普通之下皆属你家小皇帝一样
粿兒栗子 : 惨不忍睹……☠🆘💯⚰[火箭]🌋⚔[眼泪]
大概因为我丑所以我撒开了手 : 回复@四木大神:歧视女的，还什么男女平等，对不对
学会珍惜微笑 : 孩子是在停车场排排坐吃果果吗？
Colleen球球 : 五五开吧，司机看手机这条罪无可恕，可家长呢，这回有借口，如果人没看手机呢当时，负责任的说我倒车开车出停产场已经是很小心了，但三个孩子坐地上我在转弯我tm绝对盲区看不到！停车场是你家孩子玩的地方吗？！！！
黑猫大钱警长 : 不要纠结男司机女司机了，也许事实就是女司机，这三个字又不是不可说。就没人关注视频好想有个小孩手都断了，这真是一个悲剧，没死真的不幸中的万幸，再怎么样，小孩的错父母来承担，司机也没法会好过，赔偿是少不了，这还三个孩子，要是残疾了，这司机以后的日子…
小5正品美瞳免费招代理 : 觉的那个位置像是盲区，谁会在出车位的时候还看手机？3个小孩的家长也是，怎么能让小孩在停车的地方玩，还是坐在车子必经的路中间，一点安全意识都没有
静若繁花______ : 我只想说，目击者你视力真他妈好，还能观察到人家注意力“一直”在手机上！还是“一直”！你开飞机去吧，开飞机都委屈你了！！！！有这时间你没去制止吗？
橘子橘子好美腻 : 回复@Austin之城:那么大孩子在停车场玩可是么？？？
白宙容sean : 不玩手机也看不到小孩啊……
fxtxccutr : 标题为什么不是 三个小孩误坐停车场被车碾
uusky浅唱 : 为什么要强调女司机
芣莒s : 本来小孩坐地上就是盲点看不到。先不说到底看手机没，谁让你自己坐马路中间玩呢，这不是自己找死吗
就喜欢你看得到我打不到我的样子 : 人民网没有强调女司机。
燚往情深Hy : 在发达国家，停车场都是严谨小孩子单独进入或是在里面嬉闹玩耍的。
汪洁洁洁洁姐 : 博主是性别歧视吗[doge][doge]
举栗栗栗栗 : 如果能看到车里的人玩手机，那应该是离车挺近的，那为什么撞到小朋友以后没有人跑过来救人？
我喜欢穿的衣服是牛仔i : 我看见一个小孩子腿都压断了，司机该死
软耳耳東 : 谁都有过错
姑娘你长得好干净 : 回复@Becauseofyou30641:。。。。
患者多心12 : 回复@vipasyin:嗯 你说的都对  非常人的思维我是不能理解  不好意思啊[微笑]
vipasyin : 回复@北河结庐:没看见出事了孩子的坚决你就跑出来了么。我说就是活该让孩子着罪。不好好看着孩子也不好好教育孩子。得苦了司机。也苦了孩子
TST活酵母东北大区总代__娇宝 : 如果家长没叮嘱孩子，你司机就该压过去呀，说到底还是司机的错好不好！！！！！
Becauseofyou30641 : 回复@姑娘你长得好干净:哼，不要以为这样说就可以玩你了
圆滚咕噜小王子 : [微笑]为什么要强调女字？
priVarmy : 呵呵女司机[doge]
TST活酵母东北大区总代__娇宝 : 男女司机不是争论点，重点是在玩手机的司机
TST活酵母东北大区总代__娇宝 : 刚拿了驾照，不要开车了[可怜][可怜][可怜]
瞌睡的朵儿 : 就算不看手机，可看不见小孩吧，小孩儿在地上做着，车头挡着谁能看见
冎囘崰図巋 : 差不多九成人開車都是玩手機的。你難道不知道嗎？
vipasyin : 回复@患者多心12:我不会让我的孩子坐在道路上玩。这是最基本的，更何况是监护人就在旁边的人情况下更不会。那也请你换位思考一下，这样的父母带着这样的孩子出了这样的事情司机多冤枉！要孩子没在道路上坐着玩，司机能出这事么？
vipasyin : 回复@患者多心12:自己不看护和教育孩子。出了事就找别人的责任。孩子的监护者不就是这样一出一出的。从画面来看孩子的监护人就在附近。在孩子出事了立刻跑出来了。请问孩子坐在道路上玩的时候为什么不阻止不教育。不是该是什么！
我不是你的小宇宙 : 回复@远方的信笺999:没强调 只是你玻璃心
陈懒肥 : 今天去机场的路上也是一个司机开得超级慢在看手机 ，在路中间，我们的车靠边上行驶，他突然大方向盘到我们这边，还好我们的司机反应快，吓死，他还不知道怎么回事[拜拜][拜拜][拜拜]
M0nsTer-- : 为什么孩子会坐在这里？别跟我说孩子小不懂事儿，他有爸有妈却没有人教育么？
正能量转载 : 问题来了 司机上车的时候和拐弯的时候能看不到孩子？！没有提前意识？！
偏执狂加强迫症的Angelica1864 : 别玩手机，看好孩子
不胜惶恐你说 : 好像司机撞行人是司机责任....
张青霞- : 为什么坐在停车场玩 太危险了 父母也有责任
愿梦恒久比天长 : 说真的， 朋友们  开车和过马路 别做低头族了。  我也因为这样撞过车   还好人都没事。  现在想想都后怕
潇洒弟有病 : 安全意识薄弱的车主+安全意识薄弱的家长+就知道玩的熊孩子，幸好无人死亡[带着微博去旅行]
正能量转载 : 还好孩子没事！
允貂 : 看视频车处于转弯状态，小孩坐在地上，有盲点的可能性是存在的。
A-Yakira : 男人开车都玩手机的 但是小孩为什么要坐路中间[吃惊] 双方都有责任吧 
ChumiZ_haha : 如果这篇报道的题目是 三名儿童因没有家长看管在停车场玩耍导致被车辆碾压 看看舆论的毛头会不会都指向司机
木槿黎梦YU : 什么去掉女司机，重要吗？应该关心三个孩子怎么样了吧？
小萌希奥baby3 : 为什么孩子会在停车场玩呀
只不過喺陳小倩 : 难道你们男人不看手机？司机就司机，为什么要加个女字？
起风上海投资管理有限公司 : 我小区是多层的，到楼下就是路与停车位，小区外面是马路。是不是小孩子一天到晚都要待家里
Betty_Jyc : 家长如果从小教孩子不要去马路中间不去去这里那里 告诉他们不安全 。如果不宠溺 也不会这样
姑娘你长得好干净 : @Becauseofyou30641 宝贝儿   好害怕你开车耍手机喔
秋秋秋小琳 : 在停车场玩耍，家长是让孩子在那儿等si吧！
--黄燕 : 看的心惊
脸子__ : 各位司机们，不管你是男司机还是女司机，开车玩手机的都会死机的知道吗？
脱缰的母狍子 : 司机就死机被还女司机，换了男生开车你会说男司机么[微笑]
手机用户3465238050 : 我看到很多再说家长主要责任看过来肯定看的见的那个司机看了手机所以才没看到孩子说家长和孩子有责任的人真不知道是啥心态
黄佳佳妹 : @苏仕勇
没错我就是何紫琴 : 看到脱离危险了就好[祈祷]
奋不顾身的呵呵呵呵 : 回复@汪伊玲:其实我也遇到过这样的女的。。。。。。倒是没撞我，只是感觉无比恶心，谁跟这种女的结婚倒了八辈子霉
谁知未来3007 : @恐龙-蛋蛋
手机用户3465238050 : 不低头玩手机怎么会看不到
艹艹哒plus : @BlueBlueFBI
夜皎皎兮 : 白车的人有毛病吧？直接吊销驾驶证好了
精力充沛的小小小鱼 : 白车的人有问题
1234567de8 : 回复@从八品县丞:远光的确讨厌！！！！
绝处o逢生 : 你们这是都想上天啊[doge][doge][doge][doge]
Taimy : 互相让一下会死吗？
Dream丶阿冰 : 请问  前面那辆白车在玩什么[doge]看不懂
F_XxxxLin : @w_mn啊_
盆子怪_ : 这个热门没提性别 估计是俩男司机吧…刚看完隔壁热门话题女司机………
LuoWanNn : 讨厌，人家在拍电影啦
静默年华22 : 不作就不会死
致信雨果 : 激愤与速度
kingofu : 白车好恶心
从八品县丞 : 人家超我刘让他超呗，想不通了，怎么了，超一下自己就输钱折寿了吗？我开车，最讨厌的是远光狗，超车无所谓
张律师--石家庄 : 疯了吗
你应该被珍惜i : 握草，视频有点短呢
Anny_安宝儿 : 那辆白车怎么那么贱啊
ML_八村十里 : 这种人就是缺心眼
资深文人 : 心胸狭隘的人最可怕。因为毫无人情。
思路日暮 : 你俩开什么车啊，买条渔船上南海开船去
鰆鯱 : @发仔很想早睡
00mu_mu00 : 果然开起亚的都人才
气体坚固遇见 : 回复@液体坚固遇见:不是呀
slient晨曦 : 为什么不能心平气和的坐下来砍对方一刀呢
液体坚固遇见 : @气体坚固遇见 是大白吗
轻舟飞渡- : 这样做真的是不要命，不过，公路上有些东西的确是很可恶的——超车道上开得老慢、开车打电话聊微信、任性变道不开转向灯……
我老公才不是个逗比 : @桀骜的夏天
Lsir_9091230 : 只想说：白车你别把人逼急了。
GUILING84 : 终身禁驾
Eneuo : 回复@廖爸爸的微博:你知道的太多了！
子婧0878 : 前面那个挡路的车应该判他终生监禁，简直神经病！
树袋懒懒熊 : 终身禁驾，谋杀，危害公共安全
文茜Wutaoping : @鱼海洋2016
二月飞雁 : 中国现在贱人太多了，来次核爆炸重新发展吧！
廖爸爸的微博 : 王思聪为什么喜欢找网红，因为在他小时侯，你们懂得，美女也很稚嫩，看脸不看钱，他对美女垂涎三尺，却被嫌弃太丑，被女的歧视男的欺负，所以他只能和臭屌谈游戏，他还发过微博说他小时候游戏冲过很多钱，别人在花天酒地玩妞的时候他只能躲家玩游戏，所以备受打击的他现在喜欢找网红从而弥补儿时的伤。
文焕20 : 来啊互相伤害啊[doge]
ooiiiiioo : 不是常有人说得失不在乎就要争口气嘛，这口气争没争到不知他们怎么看，即算是争到了今后会不会有一刻后悔此时的作为
他叫赵泰范 : 小三与正房[笑cry][笑cry]哈哈哈哈哈
LIFE_DDDBJ : 怎么不下车拿两把刀互砍，看谁先死
司考嘉 : 危险驾驶
博三千渡 : 速度与猛兽
飞翔的猪头肉 : 妈的智障。[思考]
白胖萝卜Q : 不要命了
抗日老兵新遭遇 : 我父亲也去抗美援朝了，他的抗战履历被盘锦监狱组织部剥夺了，我们现在正在向辽宁省政府以及中组部和辽宁省委组织部以及盘锦监狱申诉。下图是我父亲，他右手拿的是抗战胜利七十周年纪念章，左臂上的凹坑是枪伤疤痕 
iiiiiKen : 这事挺严重
是江湖不是浆糊 : 可怕
徐辰爖 : 我也想知道后来怎么样了 ！
風流雨泣 : 你俩作死可以，请不要危害不相干的人
老王可不吃你这一套 : 斗气磅礴，恐怖如斯。
_陈淯 : 终身禁高速，高铁，飞机
万一点八开户 : 都到监狱里蹲个六个月！
乐我中华 : 一声叹息：拿生命斗气！
元千雅 : 想知道后来怎么样了[doge]
如果可以重来_1984 : 一时意气用事，冷静下来肯定后悔
阿大大大神 : 楼下素质真是甩[喵喵]，镜头角度这么固定应该是行车记录仪不是手机拍摄吧，还高速上是你你就停车报警的，真是服
小怪不能不 : @蓝色的雨蓝色的海
KKK小巴 : 应该是恐怖分子在演练自杀式汽车袭击，请警察尽快抓住这两个恐怖分子
最最台客 : CIA vs KGB?
依冥 : 在这评论骂人的估计开车时也会这样
家的守护神201007 : 两个猪头作死
闲话爱人 : 我想知道后来怎么样了[喵喵]
没啥好看的我知道我帅 : 妈的这种不想活的不要干扰后面的车好吗！
冷柿 : 后面拍摄者的心情是恐惧？兴奋？如果是我就要停车电话报警了，这样开下去后车也是相当危险。
最讨厌起名字_ : 回复@颜研turn:[偷笑]女司机的话对方应该早已完败
Dream丶阿冰 : 我只想说去年十一去青岛路过山东那边  大车挺多的  路也不怎么好走  就有那么点 让你隔意的车子  反正开车自己心态放好点  忍不住骂骂就行了  可别当真[拜拜]
左半边的我们 : 回复@GZJ是高小葱:视频里说了是起亚..
SpeciAlizingRoy : 回复@桃桃Let_it_go:哦 忘了告诉你 倆女司机
17Freak : 人家拍电影呢 你们起什么哄
大汪汪家的小喵喵 : 就腻歪白车这样的，现在马路上这样的疯子太多了，没事别车，占路就不让后面走，都该终身吊销驾照
黄山峰plus : 回复@迷失宇宙尽头的兔2B:我说错话害你们不高兴了对不起哦
迷失宇宙尽头的兔2B : 回复@黄山峰plus:5系好像不比你的glk便宜
欧也尼葛朗台一号 : @Zzzzz七7
颜研turn : 这次怎么没人说男司机女司机啊[微笑]
凊颩嶶涼 : 简直是拿命耍
白兔图兔图兔 : 这难道不是危险驾驶以危险方法危害公共安全。。找死去没人地方[拜拜][脸红]
漂亮可爱不能死的美伢 : 是真爱么相爱相杀
木石千仞 : 下车，两人关一个笼子里互撕。别影响他人。。
芥末_fearless : @洪小麒HXQ
李新夏 : 北方人 哈哈 不意外
ROROCHEUNG_ : @马刺球迷协会SpursChina
高山里没有高杉 : 我就不知道这种狗p事件是有人觉得光荣还是牛逼咋地～争着抢着给自己身上贴！不学点好[doge]
苏门蟲 : 现在不是已经不分行车道和超车道了吗
啤酒泡泡可乐鸡 : 一看司机就常开极品飞车
大耳朵阿贝 : 兩個神經病。得趕緊逮住他們，還得判重刑。
山野村人Kevin_Lau : 请求击毙
KLHHF : 我大山东能人辈出
邱月- : @ABCD哈哈哒
水口此角 : @我会搞笑的哦
彭飞_SG : 黑车可以利用排水渠夹道转弯超车，我想黑车司机也意识到了，车头重的问题，撞下前保险杠…
林小岚宝 : 回复@陌森的夏天:吥吥吥！我根本不是山东人啊！啊我自杀了
二西陌夫 : 垃圾。 
叉烧SAMA : 不行了哈哈哈看了视频笑到肚子痛[笑cry][笑cry][笑cry][笑cry][笑cry]
等一下的P : 好好好，女司机是最牛逼的司机，以后谁在司机前面加个女，都是侮辱女性，都是阻挡女权的前进！
大海绵丶 : 目测地域黑要出现
请府先生不要让我为难 : 回复@朕的嫔妃想害朕:2333[笑cry]
毛毛啊毛毛_ : @贝克汉美-
拾取星 : 嘿嘿..战斗明祖
张姑凉 : 故意别车的特别贱，心理变态
黄山峰plus : 回复@WIPchan:ml350和glk300 今年要买玛莎拉蒂的suv 咋了
WIPchan : 回复@黄山峰plus:五系是破车？你开的是什么？
孤人独立 : 涉嫌危害公共安全
J_1900 : 现实版《蛮荒故事》
CaptainDeadpooool : 回复@桃桃Let_it_go:可能因为俩人没有挂倒档开着雨刷器[doge][doge][doge]
黄山峰plus : 俩破车较什么劲呢
小鸡子小鸭子 : 高速超车道，低俗行驶死了活该！经常遇到！两个车并排行驶，超车道的人，就在那晃悠，真想撞死他！
_回头就当做初次遇见 : 回复@桃桃Let_it_go:因为从视频中看不出来是男司机还是女司机啊
O壹零 : 。。。真是。。都是小公主
Changes健体 : 都不会一招制胜还敢这么玩 腊鸡
剪刀手唐小唐 : 后面的车好倒霉
縋風TRAIN : H6还挺结实
不吃药的苏荻 : 少玩极品飞车，多做驾考宝典[眼泪]
不安的Turbo : EMP ONLINE@早起的雀儿被虫吃 
陆佰的围脖 : 出个论文题：论禁枪的必要性……
叮铃哐啷_比利 : 这一篇没特别强调司机性别咧，那应该就不是（）而是（）【自由填空题】
二十一克光圈 : 在山东高速开车什么感受：各种不要命的在你正在排队超车的时候往你前面钻，真不是一个两个，全都是这样，全山东的司机都是一个师傅教出来的嘛？
Kiss欢2013 : 我真佩服后面拍的那个，车速那么慢，还在高速最左车道，不怕追尾吗
二手牛忙 : 呵呵，长城，，，，傻子车，
蜀豆子 : @猫m小喵
Woodpeckerman : 回复@EmilyRiley:开的慢不要紧，开的慢靠右开。
榴莲这么大 : 可见在车上装一趟导弹发射装置是多么有效。
镇群神兽 : 这是真有病了……路怒症的…男司机？[哆啦A梦吃惊][哆啦A梦吃惊][哆啦A梦吃惊]
GlitterAndGold : 建议终身吊销驾照
一只沉默的猪123 : @張博涵乀 笑死我了
奥杰脱 : 中国电影特技后继有人了[嘻嘻]
Agnes_Lyy : 以后就别开车了 以免危及更多生命
扑向太阳的包子 : 回复@十六狐:高速上这样别车撞车，不管什么原因都是在犯罪。120码的速度下什么事都可能发生。
Sweet2523 : 建议在高速上故意别车写入法律，毕竟高速公路车速快，恶意别车造成的影响和损失会很大
MiracleZZDD : 停车打一架都比这个强 支持吊销驾照外加精神鉴定
天啦路 : 后车撞护栏，是拍视频的车吗
张书棋丶 : @陈震同学 震哥你怎么看[doge]
维多克力里昂 : 真好，如果死了最好
六眼飞鱼同学 : 转了再说 [微笑]
36经验 : 早晚在马路上被淘汰
RePWang : 用前头撞后保险杠掉了。。。。
yangsyuan- : 来啊，互相伤害啊！
美豚儿 : 很符合强国戾气[喵喵]
long4L : 开这么慢还“对飚”，是有多无聊…真觉得自己有本事好好学个赛车去赛道上比
先有唐唐 : 听着像青岛口啊
阿尔萨斯-乌瑟尔-怒风 : 估计又是其中一辆车慢慢悠悠占着左车道开。另外一辆生气别了他。俩车就开始较劲了。
阿尔萨斯-乌瑟尔-怒风 : 回复@EmilyRiley:是！开的太慢有时候比开得快还危险的。切记开的慢的话就靠最右边吧，不要占着左边车道
EmilyRiley : 冲动是魔鬼。10几年前我刚学会开车不久在五方桥附近，有一辆车一个劲的别我挤我先后好几次超完我的车再开慢再别再超，我当时完全不知道发生了什么事，除了出了一身冷汗就是随便他怎么样我就慢慢往前开。现在大概明白估计是我当时开的太慢挡他的道了所以给那位司机气成那样，可对我来说简直是莫名其妙
一直特立独行的猪猪 : @Jack_黄先生
敢爱敢做的我 : 肯定是危险方式危害公共安全罪，造成严重后果的最高可以处以死刑
毛-老湿 : 就是干不要song[doge]
当冬季变暖 : 上次坐出租车，司机也是被惹了要超车去撞，原因是因为摩托车那个人瞪了出租车司机一眼
我眼中的我就是我 : 回复@桃桃Let_it_go:因为是男司机啊[害羞]
一念天堂0 : 本来我都快信了，但看到澎湃新闻，瞬间觉得是在扯淡，这个死妈的逼媒体天天搞些唬人的噱头来哗众取宠
ERIC_DATACE : @瓜木来 西班牙那个电影真实版
胖叔叔ShawnHsu : 所以到底是危险驾驶罪还是以危险方法危害公共安全罪[doge]
伯特兰丶罗素 : 在山东做出租车我一直劝司机别冲动
周肥肉Dwight : 看的莫名带劲
HzDtjm : 两个脑残
半夜起床吊嗓子 : 真●碰碰车[抠鼻屎][抠鼻屎][抠鼻屎]
漂泊者的留恋 : 命是人家自己的，愿意霍霍就霍霍呗，人家能承担后果就让人家作去呗，大不了作死[微笑]
Gr33nwings : 回复@罡罡罡ganggang:[笑cry]
罡罡罡ganggang : @Gr33nwings
GrapeNCherry : 想起了蛮荒故事[笑cry]
GZJ是高小葱 : 五系和哈弗h6杠上，也是醉了
--粉袋鼠 : @舒_禾呈
郭江lucky : 速度与激情看多了
享福小老公 : 何必呢，这种车损保险公司是不可能赔的，自己跟自己过不起
起来去吃面 : @人多的地方捞世界
陌森的夏天 : 回复@林小岚宝:你们山东人都不怕死，真牛逼，厉害。
林小岚宝 : 回复@李塔斯:奶奶个熊！这就是俺们山东人的血性！
夜_生 : 终身禁驾
很棒很舒服_hs : 危险驾驶罪
青春丶绿 : @吖瑞0205
恍若-归梦 : 摔胳膊断腿了才知道珍惜生命怎么写[挖鼻][挖鼻]
呜大呼 : 回复@罗瞳瞳:来吧 互相伤害
糖糖Lzzz : 害人害己，吊销驾照，终身不得再开车。
菠菜之于大力水手- : 脑子是个好东西 我希望他们都能有
杨豆豆是祖国的小花朵 : @BERGKAMP_
Awesome115 : 自己想死 求不害别人
就这么孤独着去流浪 : 以危险方法危害公共安全罪！
大刀杨杨 : 黑车技术太差！完全有条件顶翻白车[嘻嘻]
日光流年兮 : 有钱人的世界我不懂
number丸儿 : 两车驾驶员都直接吊销驾照，而且永远不许再考，这样的措施才能治那些路怒症。路怒症连命都不要了，还要驾照干嘛！
如果我们的语言是威士忌ghmily : 疯子有病 要死也别在高速路上啊 你们不要命别人还要呢 幸好高速公路上车少 不然后果简直不堪设想
大萝卜sama : 回复@桃桃Let_it_go:看天下的新闻很早就改善了，不说司机性别了，你却还在这揪着不放，是不是脑残。
大萝卜sama : 看天下的新闻早就不说司机的性别了，新闻报道做了改善，还有一些人在酸来酸去是不是脑残。
鼓掌蔚蓝 : 严惩
李塔斯 : 哈哈哈好客山东欢迎您！@Paul郑褚 @林小岚宝
witwil603 : 回复@十六狐:不论是不是全部，那两位危险驾驶是逃不掉的。
卍解的橘子皮 : 回复@桃桃Let_it_go:你这有故意挑口水的嫌疑，何必呢？一定要争来争去才舒坦？
茶壶丸 : 人活一口气，一赌气离死就不远了！
轱辘山 : 回复@桃桃Let_it_go:很明显女司机没这个技术啊哈哈哈
焕J焕J焕 : @我有一个小煤球
响当当的东北汉子 : 回复@桃桃Let_it_go:男女不分[哈哈][哈哈][哈哈]
候鸟的天空1314 : 有种上秋名山啊……
桃桃Let_it_go : 回复@卍解的橘子皮:不好意思，我没有视频的暴力行为，也没有对任何人破口大骂发泄怒气，只是对现实存在的现象进行谴责[微笑]
资深搬砖蓝领蔡工 : 回复@桃桃Let_it_go:因为显然是男司机。女司机开车的话不需要别停，自己就撞上了护栏。
黄金炸洋芋 : @cJA2
我要做个逆光飞翔的他 : 山东
Ayumi的时光机 : 谁认识那辆五菱宏光？麻烦请告诉他，星期天晚上八点，我在秋名山等他。
卍解的橘子皮 : 回复@桃桃Let_it_go:你就是这种心态？和视频里的两位司机有什么区别？
tirday : 黑车怎么这么不给力呢
菠萝包上的番茄酱 : 这个是危害公共安全！抓起来吧！
一位在当地较为出色的青年 : 白越野司机： 刚从后视镜里我发现一样东西，每次你想超我的时候都很不自然，你不觉得吗  ，虽然你的雪佛兰马力很大，但是车头很重，高速上只有那几个车道，每次你换车道 就一定要推头 ，尤其是碰到急转弯，你每次都拿不准最佳路线，除非你能克服这个问题，否则你的起亚是斗不过我的哈佛H6的 。
小嫣__ : @张阿拉斯酷_
Legss : @凸皿凸Nameislin 到底是输了
做真实的我Y : 都说冲冠一怒为红颜，你俩这是闹哪般？
百四之王 : 电影拍成这样也是看不下去。。
木木大王爱吃肉 : @素的小炖肉 跟谁啊这是。。。。
高鍏 : 好牛逼啊
与拿鹤 : 香港警匪片看多了？
真的不是Bulinbulin : 我就这么静静地看着
清泉的一些事一些情 : 电影《蛮荒故事》你们可以看一下
宿命LIFE : @旧时光__2016
罗瞳瞳 : @呜大呼
Getfortune : 回复@你熊大你先上:忘了水浒传在哪发生的了[爱你][怒]
荻庐雪夜 : 越野车败下阵来
五好青年小亮哥 : 判刑吧，危害公共安全
我家小歪不在家 : 自己想死也不要害别人好吗！
卢尼卢科 : 这种人最好的结果就是把自己撞死...也别影响到其他人
Pass东森 : 疯了吧
Fabio爸爸 : @陆陆要大顺
beeeeeeeeBee : 好危险啊。自己出事不要紧，害了后面的车。。
United-公子茅台 : @PS3保罗
FFFQAQFFF : 还记得以前的新闻把违规的前车故意撞翻吗？一片叫好声。这下好，谁也别服谁，撞死才好[拜拜]
来改变 : 公路不是你们家的，危害公共安全…应该重罚
vamosvilla : @刘畅_c_c
riskey爱昆明 : 这种已经不是简单的路怒或者是斗气了，涉嫌危险方式危害公共红安全，已经可以是刑事案件了！
Andre-King : 以危险驾驶罪法办
Caterina_x : 这些人的道德和社会责任感哪去了？不为自己的生命负责，更不知道或许他们的一时冲动，会给别人的生命带来怎样的威胁。
星空太美不想睡-Mz : 澎湃的新闻？噢 晚点看结果
啓太郎 : 暴戾
蒜苔叶儿 : 还有高速上 我们开一百 旁边两辆车一阵风地超过去……
Melody_SooL : 叫人家全部放的 你以为拍电影啊 要不要放慢镜头？或者来点特技？呵呵！总之高速上这种事就是害人害己。
鸡大腿不加腿 : 回复@桃桃Let_it_go:斗气和把油门当刹车还是有本质区别的。呵呵呵呵呵呵呵呵呵
关画作关 : [握手][围观] 
孟小毯 : @生西共勉
vivi_单曲 : 自己作死也别害别人啊
雨中漫步畅想曲 : 这样还会连累其他车辆——这些人真不适合开车！
执戟踏歌 : 疯了[吃惊]
朕的嫔妃想害朕 : 大家想点好的，他们两个这么着急一定是有道理的，也许…他们俩的妈一起死了？[doge]
养猪猪小能手 : 前几天撞交警那个女的也是山东的
mooooon啊 : 怎么还有人为了斗气命都不要了[汗]
绿袍鲁道夫 : 把车牌至少公布出来吧，大家以后在别的省见到绕着走
励精图治的大农场主 : 有病
用户5201590513 : 自找死不可活。
吃桔子不吐葡萄皮儿 : 这种死一个少一个祸害吧
Scorpion娟娟儿 : @黎鑫浩29
似麦儿 : 太危险了
夜皎皎兮 : 白车的人有毛病吧？直接吊销驾驶证好了
精力充沛的小小小鱼 : 白车的人有问题
1234567de8 : 回复@从八品县丞:远光的确讨厌！！！！
绝处o逢生 : 你们这是都想上天啊[doge][doge][doge][doge]
Taimy : 互相让一下会死吗？
Dream丶阿冰 : 请问  前面那辆白车在玩什么[doge]看不懂
F_XxxxLin : @w_mn啊_
盆子怪_ : 这个热门没提性别 估计是俩男司机吧…刚看完隔壁热门话题女司机………
LuoWanNn : 讨厌，人家在拍电影啦
静默年华22 : 不作就不会死
致信雨果 : 激愤与速度
kingofu : 白车好恶心
从八品县丞 : 人家超我刘让他超呗，想不通了，怎么了，超一下自己就输钱折寿了吗？我开车，最讨厌的是远光狗，超车无所谓
张律师--石家庄 : 疯了吗
你应该被珍惜i : 握草，视频有点短呢
Anny_安宝儿 : 那辆白车怎么那么贱啊
ML_八村十里 : 这种人就是缺心眼
资深文人 : 心胸狭隘的人最可怕。因为毫无人情。
思路日暮 : 你俩开什么车啊，买条渔船上南海开船去
鰆鯱 : @发仔很想早睡
00mu_mu00 : 果然开起亚的都人才
气体坚固遇见 : 回复@液体坚固遇见:不是呀
slient晨曦 : 为什么不能心平气和的坐下来砍对方一刀呢
液体坚固遇见 : @气体坚固遇见 是大白吗
轻舟飞渡- : 这样做真的是不要命，不过，公路上有些东西的确是很可恶的——超车道上开得老慢、开车打电话聊微信、任性变道不开转向灯……
我老公才不是个逗比 : @桀骜的夏天
Lsir_9091230 : 只想说：白车你别把人逼急了。
GUILING84 : 终身禁驾
Eneuo : 回复@廖爸爸的微博:你知道的太多了！
子婧0878 : 前面那个挡路的车应该判他终生监禁，简直神经病！
树袋懒懒熊 : 终身禁驾，谋杀，危害公共安全
文茜Wutaoping : @鱼海洋2016
二月飞雁 : 中国现在贱人太多了，来次核爆炸重新发展吧！
廖爸爸的微博 : 王思聪为什么喜欢找网红，因为在他小时侯，你们懂得，美女也很稚嫩，看脸不看钱，他对美女垂涎三尺，却被嫌弃太丑，被女的歧视男的欺负，所以他只能和臭屌谈游戏，他还发过微博说他小时候游戏冲过很多钱，别人在花天酒地玩妞的时候他只能躲家玩游戏，所以备受打击的他现在喜欢找网红从而弥补儿时的伤。
文焕20 : 来啊互相伤害啊[doge]
ooiiiiioo : 不是常有人说得失不在乎就要争口气嘛，这口气争没争到不知他们怎么看，即算是争到了今后会不会有一刻后悔此时的作为
他叫赵泰范 : 小三与正房[笑cry][笑cry]哈哈哈哈哈
LIFE_DDDBJ : 怎么不下车拿两把刀互砍，看谁先死
司考嘉 : 危险驾驶
博三千渡 : 速度与猛兽
飞翔的猪头肉 : 妈的智障。[思考]
白胖萝卜Q : 不要命了
抗日老兵新遭遇 : 我父亲也去抗美援朝了，他的抗战履历被盘锦监狱组织部剥夺了，我们现在正在向辽宁省政府以及中组部和辽宁省委组织部以及盘锦监狱申诉。下图是我父亲，他右手拿的是抗战胜利七十周年纪念章，左臂上的凹坑是枪伤疤痕 
iiiiiKen : 这事挺严重
是江湖不是浆糊 : 可怕
徐辰爖 : 我也想知道后来怎么样了 ！
風流雨泣 : 你俩作死可以，请不要危害不相干的人
老王可不吃你这一套 : 斗气磅礴，恐怖如斯。
_陈淯 : 终身禁高速，高铁，飞机
万一点八开户 : 都到监狱里蹲个六个月！
乐我中华 : 一声叹息：拿生命斗气！
元千雅 : 想知道后来怎么样了[doge]
如果可以重来_1984 : 一时意气用事，冷静下来肯定后悔
阿大大大神 : 楼下素质真是甩[喵喵]，镜头角度这么固定应该是行车记录仪不是手机拍摄吧，还高速上是你你就停车报警的，真是服
小怪不能不 : @蓝色的雨蓝色的海
KKK小巴 : 应该是恐怖分子在演练自杀式汽车袭击，请警察尽快抓住这两个恐怖分子
最最台客 : CIA vs KGB?
依冥 : 在这评论骂人的估计开车时也会这样
家的守护神201007 : 两个猪头作死
闲话爱人 : 我想知道后来怎么样了[喵喵]
没啥好看的我知道我帅 : 妈的这种不想活的不要干扰后面的车好吗！
冷柿 : 后面拍摄者的心情是恐惧？兴奋？如果是我就要停车电话报警了，这样开下去后车也是相当危险。
