颖子妹妹_ : @游梦徊南
发发发发财财 : 我也会这样要求
lamxl0911 : 要求不过分，情有可原，哈哈
纸碗装的牛肉面 : 醉美女司机
尼古丁赵四 : 麻烦交警把她屎给打出来，糊她脸上，再帮她美颜
国内外绝版电子书查找 : 哈哈
faaaxyi : @-番茄si- 哈哈哈哈真的是应该和我一样[哆啦A梦汗]
屈臣氏小姐和赵丽颖 : [doge]警察叔叔说放心我会把你拍好的
-TF家族-易烊千玺 : 这广告打的厉害
程派v : 厉害了我的哥！
刘家小帅睿小宝 : 警察说  放心，我不会让你露脸
魏心怡是我是魏心怡 : 回复@挺立的松柏:醉驾以后还能驾驶吗[白眼][白眼]
今天很忙很忙很忙 : 然后她碰上一个拍照技术不好的交警[doge][doge][doge]
方狸狸 : 回复@半笙素衣:呸…
夏来了-想见宝宝龙 : 额，大概只有我觉得脑残[汗]
章菲菲是二小姐 : 醉的不轻。
瘦美人- : @_VanVanVanessa
柠檬与蜂蜜才是绝配 : 不管什么时候都要美美的[笑cry][笑cry]
你与时光皆薄凉FB : mdzz
绿菠柠7味的喵喵 : 骚呢兄弟[doge]
深睡安徒生 : 可惜我没有美图秀秀的眼睛。
火锅狮子lynn : 回复@晨风云雀:你真心的吗？
亲爱的公主病分享 : 美国恐怖故事第六季，步步惊心丽，要的点赞私我[偷乐]
萌大帅小Queen-D : 醉了。。。查那么严最近你不知道么白痴。。。[眼泪][眼泪][眼泪][眼泪]
甜哥哥哥哥 : 这交警活该单身一辈子
小公主是我吧 : 回复@是天意a:[斜眼]
Cathy最爱大晴天 : @橘子橘子我是榴莲 新疆姑娘
QM_610 : 回复@路颜旭:滚！！！ 像你们这种人、真不知道在想些什么. 一天天的就那么没事干么？
康康康康阿钰 : 说不定不是卖萌而是喝懵逼啦[笑cry][笑cry][笑cry][笑cry][笑cry]
美到冒泡泡的王小妞 : 最后交警叔叔爱上了此女生
叫我二宫萌子 : @小鹿艾希礼 来来来
劳动法专业律师程向阳 : @弓长长长长fENG
_时常博 : 今天骑电动车喝多了，就叫了个代驾，过了一会代驾也骑了个电动车来了。。。。[doge]
Softcandy- : 这个要求不是很正常吗…
后来_的-我们 : 昨天刚看到泰国那个广告 关于醉酒
鱀苊 : 23333
小小小苏苏哒 : 呵呵～
面条_面条 : @薇安安ooO 如果是你也会这样吧[喵喵]
kekekekeoo_ : [疑問][疑問][疑問][疑問]这有必要给人家发出来
Lynn-___ : 喝多了[哈哈]
温柔善良的红太狼 : @Eric行仔 卧槽哈哈哈哈哈哈哈哈
Libra陆陆陆 : 厉害了我的姐
雯雯王Vivien : 昌吉[喵喵][喵喵]@薛静Stephanie
memememeyxh : 回复@这是ZYY:[微笑][微笑]我估计当时就酒醒了、还要强装淡定
阿诺史的妈 : 一点都没醉啊
兔子爱茉莉 : 尼玛  昌吉明明是新B
妖精第568号 : 美颜相机在打广告[doge][doge][doge]
妖精第568号 : 美颜相机在打广告[doge][doge][doge]
宝宝的小贼丶 : 回复@小嘉妹93:哈哈哈哈哈哈
这是ZYY : 如果是我我也会的[害羞][害羞]@memememeyxh
字言字语- : 厉害了我的姐
sunshine平小怪 : 头可断血可流，照片不能不美颜
JUSTLIKEMEC : 今天去医院体检要查大便，我看小护士挺漂亮，于是就想到逗她一下。跑门口买了一个烤红署，捏成泥放在了大便盒里，护士说太多了，喊处理一下，我说，不用麻烦了，说完用手拿着就吃，小护士连口罩都来不及摘，当场吐了。旁边的人:兄弟，这盒才是你的…😐
Calvin张家玮 : 这女的我喜欢[眼泪]
Andy13163 : 姑娘好可爱哈哈哈
小强哒麻麻 : 请对路人生命负责，真是无语O__O&quot;…
杨静仪_zima : 新a. 乌鲁木齐的车[doge]
yannysky88 : 我若有这心就好了，被人说过你的爱美之心哪里去了
Abigail_liagaibA : 拍我可以，请用美颜相机
淘宝购物优惠券 : [微笑]来吧，这里有你想要的东西huigou123.top，复制到浏览器打开
George桑 : 回复@与你于我___:哈哈哈哈
RosaliaSwetTL璐 : 回复@马上拥有马甲线的宋尼玛:毛线[哼]
kaienhsu : 我竟然觉得这姑娘挺可爱的，这是什么情况？
情圣吗 : 骚呢兄弟[强]
鲨鱼樱花 : 该批评批评啊 醉驾不是开玩笑 美女更要注意安全 那么年轻呢
Nun969 : 哈哈
吴敏03560 : 这，我只是看看酒驾和美颜的关系
迷鹿蔓 : 回复@TahitiBee:看来真是醉了[喵喵]
马上拥有马甲线的宋尼玛 : 回复@RosaliaSwetTL璐:哥会ps[酷]
FFFunz : 画重点：醉驾！醉驾！醉驾！
哈喽亦涵 : 比逃逸不配合的司机好太多
可受可傲娇 : @我家有个小杰瑞
Enrony_hug : 酒驾，你自己出事不要紧，别伤害到无辜的人。真不负责任，脑残
FantasticPatty : 醉酒驾驶要坐牢的吧  不是扣12分拘留所几天那么简单的
RosaliaSwetTL璐 : 回复@马上拥有马甲线的宋尼玛:这个没有美颜的功能
李晓月Hedy_Lee : 任性，不吵不闹 只要求美颜。
马上拥有马甲线的宋尼玛 : 回复@RosaliaSwetTL璐:我用这个 
珠珠美眉 : 进去美颜吧[哆啦A梦汗]
Bningbb : 有多丑拍多丑吧 醉驾还在那唧唧歪歪
SLNMMSK : @宇宙无敌张美人
M闫世麟 : 我大新疆也有如此奇葩，哈哈
你是吃小瘦的小胖 : 新A的车。。新疆昌吉。。我只想说我就是昌吉的。。。。。
宇宙第一花 : @Notatthemoment 哈哈哈
努力努力再努力-LT : 哈哈，学交规呢，大于八十属于醉驾，对不对[doge]
文小懒Freya : @Helena-www 哈哈哈
张庭TST活酵母_远远 : [吃惊][吃惊][吃惊][吃惊][给力]
zHan以爱 : 神经病
Bibibobibob : @喏啦嗙噗呲 @ye-xxxy  这是我吧
-跟屁虫大萌m- : 没人觉得脑残？
林永艺l : 放心，一会监狱留档的时候一定给你拍的漂漂亮亮
恋爱保险销售经理 : 开得还是奥迪的车[doge]
与你于我___ : 回复@与你于我___:乌鲁木齐的车牌[微笑]
与你于我___ : 回复@与你于我___:乌鲁木齐的车牌[微笑]
恋爱保险销售经理 : 回复@路颜旭:走程序
与你于我___ : @George桑 @霸道总裁想吃不想胖 喝酒之前，我是新疆的。喝酒之后，新疆是我的[微笑]。竟然上热搜了！
晓钰家_J : 小朋友，喝了酒还是不要开车，万一出了什么意外。你父母怎么办啊？做事要想后果啊，真担心你
蹲在过道吃包子 : 昌吉上热搜了[doge]
恋爱保险销售经理 : 醉驾真心危险
恋爱保险销售经理 : 交警哥人耿直呀
Barbie丶小小點 : 拍多美也是坐过牢的
御子柴二音_ : 美颜相机大头贴[doge][doge][doge]
半笙素衣 : 回复@方狸狸:你就是下一个
粑粑你好酷 : 美颜要加钱的！如果不满足，我们还可以换装，换场景，感受一下条纹衣服的美！
不出门的星莎 : 啊哈哈哈！这个要求很合理
荷新子 : 可以，够任性，交警配合了吗？#醉驾 美颜# 
虞小雅 : @杨益帆都有人叫  我以前就在昌吉上的学
TahitiBee : 回复@迷鹿蔓:好拼
卿身不瘦 : 喝多了还卖萌
瓜玺 : @玺瓜 我大新疆呀[眼泪][眼泪][眼泪]
黛莎旗舰店天猫店 : 林子大了，什么鸟都有
情鱼帽仔 : 美颜相机你值得拥有
正直的向雯 : 图片评论 
Ccorrine_ : @Sssizze 哈哈哈哈可爱
小嘉妹93 : @宝宝的小贼丶
英玄小桃子 : 。
Holly_霍 : 我警告你 偷拍我可以 请用美颜相机[doge]@护肤导师七七   痘痘好了，谢谢老师[鲜花][鲜花]
这咋改昵称 : [眼泪] [眼泪]
迷鹿蔓 : @TahitiBee [眼泪]
ChicbyRB : 回复@sprit1024:笑死
sprit1024 : @ChicbyRB
sherry和鸡胸伴侣的好朋友 : @鸡胸伴侣- @sherry1920
May_Mk : 不以为耻，反以为荣[哼]
我腰求瘦点 : 醉驾比酒驾情节更严重，一旦发现醉驾都是要判刑的。
halo权达美 : 回复@闪闪nydia:这是真的
闪闪nydia : 回复@halo权达美:酒驾害人害己
有点想法与偶尔犯二 : 服。
ibuya : @夏阿猥
halo权达美 : 人家又没逃避什么责任 这样不挺可爱的嘛
糖糖糖糖糖尐姐 : 酒驾，你想死可以自己去死，可你没想过酒驾后撞到别人怎么办
pika乐悠悠 : 醉了
魏仙女在途中 : 回复@门里有只汪:大哥，出事了才有
南方咸鱼C10 : 珍爱生命
哈哈哈哈哈哈哈我有五毛钱 : @谁捡到我的丐吱吱啦 出门小心醉酒女司机
这一生慢慢走 : 确实醉了
路颜旭 : 大家好 我是新来的喷子 我想请问一下 是直接喷还是需要走什么程序
刁蛮妞子 : 哈哈哈[微笑][微笑][微笑]妹妹中毒太深 不要停止吃药→_→
雪翼文化 : #醉驾 美颜#颜值是决定一切的因素~[doge]
其实我是一个杀手 : 昌吉……
唐宁街的Larry : 万一出了事故，不知道她还能这么可地面对受害人的父母爱人和子女吗？
互联网情感专家 : 警官：不好意思 手机不支持美颜功能[拜拜]
我是紫薇啊__ : 还好没出事故[微笑]，这人真是恶心[doge]同意吗
明晰后的微光 : [生病][生病][生病]我们新疆的……能不酱丢lian么……
请叫我乖乖喵 : 神经病
日香嘉门寻 : 好淡定 好萌萌哒呀
无忧学历教育咨询 : 出事故的时候，来得及跟肇事者说“悠着点，别撞我的脸”吗？
都知道App : 钱可以罚 分可以扣 颜不能不美[doge]
丶Nini : [微笑]唉，卖萌总比发疯好~
zhuqianjie : @cccccsssskim @杨雅雪杨 这哈哈哈哈哈哈哈哈
海大富不富 : 哈哈哈我们昌吉的[笑cry][笑cry][笑cry]
夸父吧啦吧啦 : 呀……我们昌吉啊……
隔壁王师傅啊哩哩 : 儿戏他人生命的行为还要拍照漂亮 知道核心价值观几个字怎么写么 [doge]
RosaliaSwetTL璐 : 以后拍女生记得一定要用美颜相机哦@马上拥有马甲线的宋尼玛
就是姜小跳 : @改变自己-1225 哈哈哈昌吉妹子
陈信宏你压到我头发了啦 : 酒驾请终身监禁好吗。
甜甜糯米小团子 : 她以为自己酒驾被查，没有发生交通事故，不是什么大事。可是有没有想过，她酒驾，很可能撞到别人，环卫工人，非机动车，甚至普通的行人。最后的结果无非她坐牢，赔钱。可是无辜的路人呢，她毁掉的不仅是一个人的一辈子，也毁了一个家庭的一辈子。珍爱生命，不光是珍爱自己的。
team四员 : 任性小主
戒西游-2 : 中华民族到了最缺德的时候。跟那些动不动捞几百亿的相比，这点小事算个屁啊~so,美女，加油~
钱贝 : 果然醉了
是天意a : @小公主是我吧 如果昨天你在新疆这个人就是你
静静流年0816 : 还是有自知之明的，知道长得丑
天舞沙 : 新疆居然因为这种新闻上热搜，哎～别光自己美颜了，请你给新疆也美个颜！
O木十木O : 请自重，请不要害人！
一支民谣- : 图片评论 
十三酱说西瓜很甜 : 回复@青木泽北:四级报名又开始啦。[doge]
Leschoristes- : 自己不要命就算了，别人还想活着[微笑]
鸭子河河长 : @博哥儿_
李燕如-Liyanru : @魏丹娜LAREINA
与CUMT不醉不休 : 为什么我想和这样的人交盆友[doge]那么多讽刺她得，只有我觉得她生活中应该也是一个很有趣的人？
Miomo魚子 : 回复@hilllllllllll:哈哈哈哈哈哈
梦与月- : @-小球球吖 [doge][doge]老乡
加碘de酥油茶 : 醉驾不是已经上升到刑事犯罪了吗
门里有只汪 : 回复@魏仙女在途中:是有刑事责任的啊。。。。
