一呵呵呵哒 : 回复@娜宝996:这句真的戳中泪点了[泪][泪]
tina原来你也在这里 : 回复@杨洋iore:[泪][泪][泪][泪][泪][祈祷]
X太阳女神 : 猫猫…是你的小名吧！猫猫你要快乐 要继续那个坏坏的笑！很帅，完全是男朋友的类型！谢谢你来过这个世界！如果你累了 及时的告别没有错！
谢梓安2 : 回复@Miss曼芃:突然觉得喉咙哽咽了一下
丫丫_57379 : 乔恩不哭
冉若缘R : 陈乔恩不要难过
PopGu-ChangeCrew : 一路走好，天妒英才！
夜来幽梦忽还乡-宁 : 放過他們吧
Liu19940117 : 这个时候还不哭就来不及了
乔恩女神love : 乔恩女神，愿你重现笑容，向日葵永在
ZX_莲 : 我是路人粉 已经哭的不行 我记得他温暖的笑 这个喜欢粉红色的男孩让我一下子就记住了他 太好了 他不会再有烦恼了
M科-M : kimi还没有看到乔恩收获幸福嫁人啊……
周璐大璐子 : 回复@慢慢慢的丶:真正做公益的人，就会像你这样，在人家头七这天，在别人哀悼的微博下面，大肆宣扬人家是三线小明星，不值得这么多人哀悼？
FangLiLi921 : 谁去了现场
yxggxing : 今天晚上在寝室点了蜡烛手机放在旁边放着你的歌和你在一起看着蜡烛很亮就像你一样放着歌单曲循环一遍一遍歌词里的每一句每一个字都能想起你的样子低着头祈祷希望你所有都好睡到床上蜡烛依然很亮就像永远不会熄灭一样很奇怪寝室很安静没有一个人说一句话开始又看你的照片哭了蜡烛还很亮是你还在我们身边
Fanshu谕_293 : 我现在都不敢相信你去了天堂
一年级一班班主任 : 回复@青未秋分:就是，已经很悲痛了，哪有时间发微博
魔怔姑娘 : 人花两年学会说话 却花一辈子学会闭嘴  谨言慎行 多一分理智 少十分伤害！
铿C吻雯 : 回复@天马栖梦 的赞:谢谢，我们一直爱着他[心][心][心]
李牟嘻嘻嘻 : 从来也不是他的粉，也没有特别关注过他，但是今天在街上刷微博，居然也止不住眼泪了。真的好像说，每个人都善良些该有多好
yn颜捺 : 走好[心]
抱歉v : 怕是今天过后很少再会有人提到乔任梁了吧这样也好让他在另一个世界安安静静没有舆论的好好生活[心]走好
哆啦B梦乡 : 真是不与傻瓜论短长！谁死谁活跟那些脑残的局外人有毛事！！！人家朋友发不发微博更是跟你有屁关系！！！说白了就是丑人多做怪，心里变态！！！
halo丿丶 : 不相信，看了hello女神那期节目，不相信他真的离开了[悲伤]
littlekimi : 去年的今天也是我公公的出殡日
马蓉出轨视频免费发 : 祈祷
Waiting曹 : 真的，建议未成年人禁止开微博，因为他们根本就不知道为自己的言行负责！！
庚加珍汐你HG : 到现在还是不敢相信[泪]
她呼吸他的呼吸_ : 谁也不曾想阳光灿烂的背后是忧郁绝望的灵魂！若上帝要把你带走，谁也无法将你留下！这段旅程你来过，在大家还没来得及回头时，你已消失无踪！就像一阵雨洗尽尘世蹉跎！就像一束光炽烈燃尽褪幽暗！世界不会停止车水马龙，人们会继续于人潮人往！光年以后谁也不会记得谁！渺小如你大海一栗！再见！祈祷！
Dodobaby_R : 其实以前没有怎么过多关注过他，但是从得知他过世到今天，我仍然接受不了他去世的事实，真遗憾已这种方式多关注他[泪][泪][泪]
慢慢慢的丶 : 回复@周璐大璐子:我做了我能做的公益！那你呢
TingZz婷 : 或许未来也可以像华哥和心如一样成为一对，结果一个先走了…
莱茵河畔的容嬷嬷monster : 好难受，自从知道乔任梁去世这是第一次评有关的微博，真的不敢相信，刚刚在一个微博账号看见他的遗体照片，我真的不懂有些人为什么就不能让他好好的走，就连遗体照都不放过，真的很过分很过分，希望大家看见都投诉，不要让这些照片流出来，就放他好好的走吧。希望天堂没有痛苦，乔任梁祝福你
维特戈多 : 即使不是朋友 也觉得很可惜
Xie卉卉卉 : 难受
红星闪闪小屁孩lin : 深知这种失去最亲爱的朋友的这种痛苦，[泪][泪][泪]
红星闪闪小屁孩lin : 深知这种失去最亲爱的朋友的这种痛苦，[泪][泪][泪]
天马栖梦 : 无论如何，节哀顺变，人总是要往前看[微风][微风][微风][微风][微风]
猫跟雏菊 : 回复@人民日l报:你会有报应的
ai萌小主 : 真搞不明白，之前乔恩没有发微博有些人心理变态说乔恩，现在网络怎么了
人可木木幺工 : 心疼
vivianmachina : 那为什么不在他需要的时候帮助他恢复治疗呢
温玲儿lingling : 路人表示很难过  希望我们都可以珍惜身边的人
静心咒007 : 人家不发微博你们就骂别人，他们的友谊，他们自己知道就好了，你们为什么要喷别人呢！乔任梁已经走了，就是因为你们这些喷子！你们还要怎样？
緈福在鎆祊 : 看得好难过
高玉莹同学 : 回复@拉风的Aj:你是来找骂的吗智障
周璐大璐子 : 回复@慢慢慢的丶:至少比你强，不会到处宣泄一些你认为对的又不去做的理论，还说人家三线小明星，但是人家就是粉丝多啊！所以影响力大啊！你看不惯也没整
静心咒007 : 你们这些喷子赶快滚！
箛箛僤僤 : 回复@慢慢慢的丶:博主挺住！像你说实话的人已经不多了
小纸嫣 : 看乔恩的手指就知道什么情况了好吗，懂微表情的粗来，愿在乎的人陪伴一辈子。
鲸鱼的小虾米-HJY : 一路走好[蜡烛]，到了那个世界要开心
鲸鱼的小虾米-HJY : 一路走好[蜡烛]，到了那个世界要开心
晚睡早起的老年十七 : 这个面具，想起了那期快本。
是夏天嘛 : 让人动容。不禁红了眼眶...希望乔恩可以带着kimi的梦想好好生活...[悲伤]
Wallace兔叽耶 : 行 早上谁说陈乔恩不去的 还骂人家 可以 很强势 很能喷 大写的服
大白菜很妖娆 : 非要看到她哭了，你们就觉得好了，人性，可怕
余生1998_ : 陈乔恩要是不哭你们会放过人家？
丑陋的她ugly : 一路走好[红桃]永远记住这世上曾有一个很好的乔任梁[心]
用户2439911854 : 乔恩你要加油[左上](^ω^)[右上]好好活着！乔任梁会在天上保佑你的！还有乔任梁希望你在天之灵把那些恶毒的贱盘侠都带走
派大星我是不是你的海绵baby : 回复@Miss曼芃:戳中泪点
WWT吃了烤鴨就笑 : 乔恩要坚强
短发披肩D : 看到最后一张照片哭了
许艾以生 : 好心痛
焦黄糖糖 : 心疼[伤心]
巴西OS瘦身咖啡总代理 : 愿天堂没有疼苦[心]
5433-獸獸 : 图片评论 
胡颖恩 : 一路走好[泪]
美琪越努力越幸运 : 回复@MM夏MM:看到陈乔恩哭了，好心疼[悲伤]，什么安慰的话都说不出来了[悲伤]。希望乔恩能尽早从失去好友的悲伤中走出来，只有活得更好，乔任梁在那边才会安心[心]
小医生在奥运年 : 难忘的小虎牙~
小医生在奥运年 : 难忘的小虎牙~
西米西米m : 看到最后一张照片突然鼻酸
起风了TF : 还是别报道了，让他安息
小宇想换个名字后缀 : 我们陌生人都哭了，她能不哭？这叫什么热搜
an然ly : 受教育懂得焚毁遗嘱，做一个体面的人，为人所爱，受人敬重，而不是去做一个屡犯的偷表贼，受到法律对五种情状的加重处罚，解赴格雷伏刑场处死，受人憎恨和名誉扫地。[奥特曼]4567901234567890123 
花花你给我过来 : 心疼[泪][泪]
科先森_MVP : 我只想说，舆论和网络暴力已经害了多少人了，kimi有很大一部分就是因为这个原因才会抑郁！这种悲剧可以停止了吗！不要再用这样批判恶毒的字眼伤害还活着的人！
楊茵茵ve : 心疼乔恩
-Shiwing : 青春期都是看他拍的偶像剧，一开始看到这个消息的时候我简直不敢相信，这几天微博一直都是关于他的事情，看着看着很想哭，听了强迫症更想哭[泪]一路走好[祈祷][祈祷][祈祷]
i情绪病 : 明星哭没哭跟媒体有什么关系呢？怎么不把到场的亲朋好友都报道一遍 谁哭谁没哭[哼][哼][哼][哼]
i情绪病 : 明星哭没哭跟媒体有什么关系呢？怎么不把到场的亲朋好友都报道一遍 谁哭谁没哭[哼][哼][哼][哼]
Zwwwwwww__ : 心疼心痛[泪][泪][泪][蜡烛][蜡烛][蜡烛]
Aki_73 : 乔任梁肯定是爱陈乔恩
姑娘你是废物吗f : 我相信她的感情是真的[心]
Hurray_O十婷 : 乔任梁[泪][泪][泪]那么多亲人朋友为你伤心难过到崩溃[悲伤][悲伤][悲伤][伤心][伤心][伤心]那么多粉丝求你发微博辟谣[悲伤][悲伤][悲伤][伤心][伤心][伤心]连那么多不是你的粉丝都求你别走[悲伤][悲伤][悲伤][泪][泪][泪]假如你在天上看到这一幕一幕你应该会不舍得走吧[悲伤][悲伤][悲伤][泪][泪][泪]
雾霾指数8星 : 希望中国少一些喷子！
韓凯杰- : 嗯，天堂是粉红色[蜡烛] 无限惋惜
二谦是我的上上谦 : 怎么鬼鬼呢？名气太小吗？
慢慢慢的丶 : 回复@周璐大璐子:那你呢？
蕙质澜心的我 : 乔恩，带着他给你满满的爱坚强的生活，作为粉丝会继续带着他的爱好好的陪你。
Y_妍孜 : [蜡烛][蜡烛][蜡烛]
AwuXue : 啊啊啊啊 我都不敢再去想他
是熹不是喜m : 回复@Miss曼芃:这句话真心戳中泪点啊
Listen-MyHeart逆 : 心疼啊[泪]
wuliyinger : 到现在都不敢相信  难过
wuliyinger : 到现在都不敢相信  难过
拥抱太阳的星星啊 : 回复@Miss曼芃:泪流
木易吉吉yz : 作为路人我真的好难过[泪]
qwertuiiiooppp : 回复@独醒的醉人:大家不要理他这种人。他想火。让他的回复沉下去。kimi离开就是因为这种垃圾太多了
尼扎步尚添 : 回复@人民日l报:人真的是会有报应的，居然还有人给你点赞，人心居然能黑暗到这种地步，太可怕了[拜拜]
-男神王俊凯人气荣耀永不磨灭 : 你怎么舍得扔下乔恩。看到这里突然心里还是很难受
周璐大璐子 : 回复@慢慢慢的丶:你有病吧？发这个和爱国不爱国是两码事，爱国就要天天报道国家大事吗？那我问你，你这么爱国，你点进你所谓的三线小明星这里，说这么两句干嘛？你那么爱国，你又为国家做什么了？
timi坏小孩 : 陈乔恩和乔任梁，纯洁的友谊。
timi坏小孩 : 陈乔恩和乔任梁，纯洁的友谊。
田家碧玉一杆枪 : 你怎么舍得扔下乔恩。[大哭]看到这里突然心里还是很难受[大哭]
张抽抽hg : 心疼
我也姓周啊 : 心疼
ndjdid : 乔恩不哭他还在我们心中
Lixt-k : 回复@夏央未海:没错 只有亲人才会穿一身白
咩咩的圈外老婆 : 看到最后一张眼泪就这么掉下来[泪][泪][泪]
铿C吻雯 : 回复@Miss曼芃:余生，我只想把我该有的爱，都为你埋藏在心底，只爱你一个，从此以后，一个人走天涯[心][心][心][心]
香樟丶流年 : 回复@那人曾叫李靠谱:我也觉得有水军有炒作，老实说他去世之前我都不知道他，一去世整个网络都沸腾了，有那么夸张吗，这个世界上每天有多少人因为各种原因去世，媒体夸张了。
SUYILIAN : 路人的我哭了好几波[悲伤]
王俊凯k桃花眼 : 看着最后一张照片真的好难过！
一个天蝎座的chan : 回复@一个天蝎座的chan:苏醒  怀才不遇  如果你知道薛之谦  那么苏醒也是用心做音乐的  希望更多人认识
娟CHOW女王 : 真的心痛啊！[泪][泪][泪][泪][泪][泪]kimi一路走好，以前没怎么关注你，对不起，原谅我[泪][泪][泪][泪][泪][泪][祈祷][祈祷][祈祷][祈祷][祈祷][祈祷]一路走好
零--zero零 : 想起黄家驹，虽然懂得听他的歌，知道他的人的时候，他已经去世了，但是没有任何一个明星的逝世能比黄家驹的离世更让人悲痛，励志传奇却又短暂的一生留下的尽是经典之作！对乔任梁的认识仅仅来自于他的死讯，之前毫无印象！当全世界都在关注陈乔恩哭不哭的时候，真感觉这是一场华丽丽的道德绑架！
潘潘糖 : 路人甲的我早已泪流满面，心疼真爱粉和乔爸乔妈，亲朋好友。
阿文文文supe : 回复@夏央未海:假哭 哭的那么痛心啊 键盘侠们真是找自我存在感 不怕报应 谴责 心疼乔恩和kimi
阿豆豆小猫咪 : 好心疼
MENG--朦 : 若是生命中很重要的人毫无征兆突然身亡，那种悲痛 哪还有功夫有心情发微博发朋友圈！所以一开始的那些喷子，看来你们肯定没经历过！
乔之任梁 : 如果kimi早知道你们这么爱他，他就不会自杀了。
金盆洗脚的美少女 : 回复@Miss曼芃:瞬间泪奔
沙西瓜沙沙 : 你像大白一样蠢萌 却又像大白一样离去[伤心][悲伤]
Yan宏 : 网喷你们欠乔恩一句道歉！！！
蕴秀青绫 : 我看哭了
G_sssssss : 真的不想你离开乔先生 余生我们都会帮你爱你最宠爱的女人乔恩的 你没做到的我们替你完成 天堂没有烦恼愿你一路走好 [蜡烛]
